Date,YYYYMMDD,YYYYMM,YYYY.W,YYYY,Location,Card,Delta,Balance,Category,Tags
12/31/2021,20211231,202112,2021.52,2021,Quest Diagnostics,Debit-Card,172,1270,health,"None,"
12/29/2021,20211229,202112,2021.52,2021,Ulta Beauty,Debit-Card,-811,1098,health,"None,"
12/28/2021,20211228,202112,2021.52,2021,CBRE Group,Debit-Card,625,1909,invest,"None,"
12/28/2021,20211228,202112,2021.52,2021,TIAA,Debit-Card,-946,1284,unk,"None,"
12/28/2021,20211228,202112,2021.52,2021,Hewlett Packard Enterprise,Debit-Card,-170,2230,tech,"None,"
12/27/2021,20211227,202112,2021.52,2021,Tapestry,Debit-Card,477,2400,clothing,"None,"
12/27/2021,20211227,202112,2021.52,2021,Voya Financial,Debit-Card,-913,1923,invest,"None,"
12/24/2021,20211224,202112,2021.51,2021,Quest Diagnostics,Debit-Card,719,2836,health,"None,"
12/24/2021,20211224,202112,2021.51,2021,Hanesbrands,Debit-Card,286,2117,unk,"None,"
12/24/2021,20211224,202112,2021.51,2021,Sysco,Debit-Card,863,1831,misc,"None,"
12/22/2021,20211222,202112,2021.51,2021,Hanesbrands,Debit-Card,867,968,unk,"None,"
12/21/2021,20211221,202112,2021.51,2021,Tapestry,Debit-Card,-127,101,clothing,"None,"
12/20/2021,20211220,202112,2021.51,2021,Travelers,Debit-Card,730,228,travel,"None,"
12/20/2021,20211220,202112,2021.51,2021,CBRE Group,Debit-Card,-795,-502,invest,"None,"
12/20/2021,20211220,202112,2021.51,2021,Walmart,Debit-Card,-374,293,grocery,"None,"
12/20/2021,20211220,202112,2021.51,2021,Walmart,Debit-Card,928,667,grocery,"None,"
12/20/2021,20211220,202112,2021.51,2021,Delta Air Lines,Debit-Card,645,-261,travel,"None,"
12/20/2021,20211220,202112,2021.51,2021,Visa,Debit-Card,-178,-906,debt,"None,"
12/20/2021,20211220,202112,2021.51,2021,Voya Financial,Debit-Card,-433,-728,invest,"None,"
12/17/2021,20211217,202112,2021.5,2021,Delta Air Lines,Debit-Card,-153,-295,travel,"None,"
12/15/2021,20211215,202112,2021.5,2021,CBRE Group,Debit-Card,-386,-142,invest,"None,"
12/15/2021,20211215,202112,2021.5,2021,PPL,Debit-Card,20,244,paypal,"None,"
12/13/2021,20211213,202112,2021.5,2021,Ulta Beauty,Debit-Card,75,224,health,"None,"
12/13/2021,20211213,202112,2021.5,2021,Hewlett Packard Enterprise,Debit-Card,-153,149,tech,"None,"
12/13/2021,20211213,202112,2021.5,2021,Quest Diagnostics,Debit-Card,590,302,health,"None,"
12/13/2021,20211213,202112,2021.5,2021,Travelers,Debit-Card,-82,-288,travel,"None,"
12/13/2021,20211213,202112,2021.5,2021,Ulta Beauty,Debit-Card,752,-206,health,"None,"
12/13/2021,20211213,202112,2021.5,2021,Entergy,Debit-Card,540,-958,utility,"None,"
12/13/2021,20211213,202112,2021.5,2021,Delta Air Lines,Debit-Card,-229,-1498,travel,"None,"
12/13/2021,20211213,202112,2021.5,2021,Hanesbrands,Debit-Card,124,-1269,unk,"None,"
12/10/2021,20211210,202112,2021.49,2021,TIAA,Debit-Card,-241,-1393,unk,"None,"
12/09/2021,20211209,202112,2021.49,2021,Walmart,Debit-Card,-146,-1152,grocery,"None,"
12/09/2021,20211209,202112,2021.49,2021,Walmart,Debit-Card,-584,-1006,grocery,"None,"
12/09/2021,20211209,202112,2021.49,2021,Hewlett Packard Enterprise,Debit-Card,49,-422,tech,"None,"
12/08/2021,20211208,202112,2021.49,2021,Sysco,Debit-Card,289,-471,misc,"None,"
12/07/2021,20211207,202112,2021.49,2021,Tapestry,Debit-Card,713,-760,clothing,"None,"
12/06/2021,20211206,202112,2021.49,2021,Ulta Beauty,Debit-Card,315,-1473,health,"None,"
12/06/2021,20211206,202112,2021.49,2021,Entergy,Debit-Card,-842,-1788,utility,"None,"
12/06/2021,20211206,202112,2021.49,2021,Tapestry,Debit-Card,-674,-946,clothing,"None,"
12/06/2021,20211206,202112,2021.49,2021,CBRE Group,Debit-Card,397,-272,invest,"None,"
12/03/2021,20211203,202112,2021.48,2021,CBRE Group,Debit-Card,319,-669,invest,"None,"
12/03/2021,20211203,202112,2021.48,2021,Hewlett Packard Enterprise,Debit-Card,-286,-988,tech,"None,"
12/02/2021,20211202,202112,2021.48,2021,Entergy,Debit-Card,999,-702,utility,"None,"
12/01/2021,20211201,202112,2021.48,2021,TIAA,Debit-Card,693,-1701,unk,"None,"
11/30/2021,20211130,202111,2021.48,2021,CBRE Group,Debit-Card,240,-2394,invest,"None,"
11/30/2021,20211130,202111,2021.48,2021,TIAA,Debit-Card,-192,-2634,unk,"None,"
11/30/2021,20211130,202111,2021.48,2021,Ulta Beauty,Debit-Card,924,-2442,health,"None,"
11/30/2021,20211130,202111,2021.48,2021,Ulta Beauty,Debit-Card,53,-3366,health,"None,"
11/30/2021,20211130,202111,2021.48,2021,CBRE Group,Debit-Card,122,-3419,invest,"None,"
11/29/2021,20211129,202111,2021.48,2021,Hanesbrands,Debit-Card,794,-3541,unk,"None,"
11/29/2021,20211129,202111,2021.48,2021,TIAA,Debit-Card,348,-4335,unk,"None,"
11/29/2021,20211129,202111,2021.48,2021,Voya Financial,Debit-Card,940,-4683,invest,"None,"
11/26/2021,20211126,202111,2021.47,2021,PPL,Debit-Card,-219,-5623,paypal,"None,"
11/26/2021,20211126,202111,2021.47,2021,Travelers,Debit-Card,-11,-5404,travel,"None,"
11/26/2021,20211126,202111,2021.47,2021,Cognizant Technology Solutions,Debit-Card,759,-5393,tech,"None,"
11/24/2021,20211124,202111,2021.47,2021,Cognizant Technology Solutions,Debit-Card,-751,-6152,tech,"None,"
11/24/2021,20211124,202111,2021.47,2021,CBRE Group,Debit-Card,294,-5401,invest,"None,"
11/24/2021,20211124,202111,2021.47,2021,Tapestry,Debit-Card,70,-5695,clothing,"None,"
11/23/2021,20211123,202111,2021.47,2021,Cognizant Technology Solutions,Debit-Card,-473,-5765,tech,"None,"
11/23/2021,20211123,202111,2021.47,2021,Hershey,Debit-Card,-431,-5292,grocery,"None,"
11/23/2021,20211123,202111,2021.47,2021,Quest Diagnostics,Debit-Card,109,-4861,health,"None,"
11/23/2021,20211123,202111,2021.47,2021,Hanesbrands,Debit-Card,81,-4970,unk,"None,"
11/23/2021,20211123,202111,2021.47,2021,PPL,Debit-Card,835,-5051,paypal,"None,"
11/22/2021,20211122,202111,2021.47,2021,Hershey,Debit-Card,591,-5886,grocery,"None,"
11/22/2021,20211122,202111,2021.47,2021,PPL,Debit-Card,-745,-6477,paypal,"None,"
11/22/2021,20211122,202111,2021.47,2021,TIAA,Debit-Card,-837,-5732,unk,"None,"
11/22/2021,20211122,202111,2021.47,2021,Ulta Beauty,Debit-Card,-418,-4895,health,"None,"
11/22/2021,20211122,202111,2021.47,2021,Sysco,Debit-Card,99,-4477,misc,"None,"
11/22/2021,20211122,202111,2021.47,2021,Travelers,Debit-Card,396,-4576,travel,"None,"
11/19/2021,20211119,202111,2021.46,2021,Cognizant Technology Solutions,Debit-Card,780,-4972,tech,"None,"
11/18/2021,20211118,202111,2021.46,2021,United Continental Holdings,Debit-Card,530,-5752,invest,"None,"
11/18/2021,20211118,202111,2021.46,2021,TIAA,Debit-Card,-401,-6282,unk,"None,"
11/18/2021,20211118,202111,2021.46,2021,CBRE Group,Debit-Card,-491,-5881,invest,"None,"
11/17/2021,20211117,202111,2021.46,2021,CBRE Group,Debit-Card,28,-5390,invest,"None,"
11/17/2021,20211117,202111,2021.46,2021,Hershey,Debit-Card,995,-5418,grocery,"None,"
11/16/2021,20211116,202111,2021.46,2021,Entergy,Debit-Card,751,-6413,utility,"None,"
11/16/2021,20211116,202111,2021.46,2021,Delta Air Lines,Debit-Card,310,-7164,travel,"None,"
11/15/2021,20211115,202111,2021.46,2021,CBRE Group,Debit-Card,169,-7474,invest,"None,"
11/15/2021,20211115,202111,2021.46,2021,PPL,Debit-Card,82,-7643,paypal,"None,"
11/15/2021,20211115,202111,2021.46,2021,Walmart,Debit-Card,942,-7725,grocery,"None,"
11/12/2021,20211112,202111,2021.45,2021,Visa,Debit-Card,38,-8667,debt,"None,"
11/12/2021,20211112,202111,2021.45,2021,Hershey,Debit-Card,931,-8705,grocery,"None,"
11/12/2021,20211112,202111,2021.45,2021,PPL,Debit-Card,-629,-9636,paypal,"None,"
11/12/2021,20211112,202111,2021.45,2021,Sysco,Debit-Card,-633,-9007,misc,"None,"
11/12/2021,20211112,202111,2021.45,2021,Quest Diagnostics,Debit-Card,-436,-8374,health,"None,"
11/12/2021,20211112,202111,2021.45,2021,Entergy,Debit-Card,-113,-7938,utility,"None,"
11/12/2021,20211112,202111,2021.45,2021,Tapestry,Debit-Card,-90,-7825,clothing,"None,"
11/10/2021,20211110,202111,2021.45,2021,PPL,Debit-Card,-233,-7735,paypal,"None,"
11/09/2021,20211109,202111,2021.45,2021,CBRE Group,Debit-Card,131,-7502,invest,"None,"
11/08/2021,20211108,202111,2021.45,2021,United Continental Holdings,Debit-Card,787,-7633,invest,"None,"
11/08/2021,20211108,202111,2021.45,2021,PPL,Debit-Card,995,-8420,paypal,"None,"
11/08/2021,20211108,202111,2021.45,2021,CBRE Group,Debit-Card,226,-9415,invest,"None,"
11/08/2021,20211108,202111,2021.45,2021,Cognizant Technology Solutions,Debit-Card,-844,-9641,tech,"None,"
11/08/2021,20211108,202111,2021.45,2021,Travelers,Debit-Card,-536,-8797,travel,"None,"
11/08/2021,20211108,202111,2021.45,2021,Walmart,Debit-Card,-113,-8261,grocery,"None,"
11/05/2021,20211105,202111,2021.44,2021,Tapestry,Debit-Card,124,-8148,clothing,"None,"
11/05/2021,20211105,202111,2021.44,2021,Delta Air Lines,Debit-Card,-883,-8272,travel,"None,"
11/05/2021,20211105,202111,2021.44,2021,CBRE Group,Debit-Card,397,-7389,invest,"None,"
11/04/2021,20211104,202111,2021.44,2021,Visa,Debit-Card,-650,-7786,debt,"None,"
11/04/2021,20211104,202111,2021.44,2021,PPL,Debit-Card,-107,-7136,paypal,"None,"
11/03/2021,20211103,202111,2021.44,2021,Tapestry,Debit-Card,-76,-7029,clothing,"None,"
11/02/2021,20211102,202111,2021.44,2021,TIAA,Debit-Card,358,-6953,unk,"None,"
11/02/2021,20211102,202111,2021.44,2021,Delta Air Lines,Debit-Card,-926,-7311,travel,"None,"
11/01/2021,20211101,202111,2021.44,2021,TIAA,Debit-Card,191,-6385,unk,"None,"
11/01/2021,20211101,202111,2021.44,2021,Delta Air Lines,Debit-Card,-6,-6576,travel,"None,"
11/01/2021,20211101,202111,2021.44,2021,Voya Financial,Debit-Card,139,-6570,invest,"None,"
11/01/2021,20211101,202111,2021.44,2021,Ulta Beauty,Debit-Card,-589,-6709,health,"None,"
10/29/2021,20211029,202110,2021.43,2021,TIAA,Debit-Card,-134,-6120,unk,"None,"
10/25/2021,20211025,202110,2021.43,2021,Visa,Debit-Card,-670,-5986,debt,"None,"
10/25/2021,20211025,202110,2021.43,2021,Quest Diagnostics,Debit-Card,-476,-5316,health,"None,"
10/25/2021,20211025,202110,2021.43,2021,Hewlett Packard Enterprise,Debit-Card,873,-4840,tech,"None,"
10/25/2021,20211025,202110,2021.43,2021,TIAA,Debit-Card,-303,-5713,unk,"None,"
10/25/2021,20211025,202110,2021.43,2021,PPL,Debit-Card,-690,-5410,paypal,"None,"
10/25/2021,20211025,202110,2021.43,2021,Quest Diagnostics,Debit-Card,525,-4720,health,"None,"
10/22/2021,20211022,202110,2021.42,2021,Hanesbrands,Debit-Card,480,-5245,unk,"None,"
10/22/2021,20211022,202110,2021.42,2021,Walmart,Debit-Card,-926,-5725,grocery,"None,"
10/22/2021,20211022,202110,2021.42,2021,Walmart,Debit-Card,-541,-4799,grocery,"None,"
10/22/2021,20211022,202110,2021.42,2021,Sysco,Debit-Card,-651,-4258,misc,"None,"
10/20/2021,20211020,202110,2021.42,2021,Entergy,Debit-Card,703,-3607,utility,"None,"
10/20/2021,20211020,202110,2021.42,2021,CBRE Group,Debit-Card,829,-4310,invest,"None,"
10/20/2021,20211020,202110,2021.42,2021,Cognizant Technology Solutions,Debit-Card,112,-5139,tech,"None,"
10/19/2021,20211019,202110,2021.42,2021,CBRE Group,Debit-Card,512,-5251,invest,"None,"
10/18/2021,20211018,202110,2021.42,2021,Voya Financial,Debit-Card,646,-5763,invest,"None,"
10/18/2021,20211018,202110,2021.42,2021,Hershey,Debit-Card,555,-6409,grocery,"None,"
10/18/2021,20211018,202110,2021.42,2021,Hershey,Debit-Card,429,-6964,grocery,"None,"
10/18/2021,20211018,202110,2021.42,2021,Delta Air Lines,Debit-Card,352,-7393,travel,"None,"
10/18/2021,20211018,202110,2021.42,2021,Hewlett Packard Enterprise,Debit-Card,-851,-7745,tech,"None,"
10/18/2021,20211018,202110,2021.42,2021,Hanesbrands,Debit-Card,348,-6894,unk,"None,"
10/18/2021,20211018,202110,2021.42,2021,Quest Diagnostics,Debit-Card,-637,-7242,health,"None,"
10/18/2021,20211018,202110,2021.42,2021,Voya Financial,Debit-Card,-587,-6605,invest,"None,"
10/15/2021,20211015,202110,2021.41,2021,Voya Financial,Debit-Card,-887,-6018,invest,"None,"
10/15/2021,20211015,202110,2021.41,2021,Walmart,Debit-Card,245,-5131,grocery,"None,"
10/15/2021,20211015,202110,2021.41,2021,CBRE Group,Debit-Card,415,-5376,invest,"None,"
10/14/2021,20211014,202110,2021.41,2021,Hershey,Debit-Card,-401,-5791,grocery,"None,"
10/14/2021,20211014,202110,2021.41,2021,PPL,Debit-Card,-836,-5390,paypal,"None,"
10/13/2021,20211013,202110,2021.41,2021,United Continental Holdings,Debit-Card,741,-4554,invest,"None,"
10/12/2021,20211012,202110,2021.41,2021,Visa,Debit-Card,-879,-5295,debt,"None,"
10/12/2021,20211012,202110,2021.41,2021,Ulta Beauty,Debit-Card,-357,-4416,health,"None,"
10/12/2021,20211012,202110,2021.41,2021,Voya Financial,Debit-Card,-762,-4059,invest,"None,"
10/12/2021,20211012,202110,2021.41,2021,Delta Air Lines,Debit-Card,-408,-3297,travel,"None,"
10/12/2021,20211012,202110,2021.41,2021,TIAA,Debit-Card,64,-2889,unk,"None,"
10/12/2021,20211012,202110,2021.41,2021,TIAA,Debit-Card,333,-2953,unk,"None,"
10/08/2021,20211008,202110,2021.4,2021,Hewlett Packard Enterprise,Debit-Card,-308,-3286,tech,"None,"
10/07/2021,20211007,202110,2021.4,2021,Entergy,Debit-Card,-829,-2978,utility,"None,"
10/06/2021,20211006,202110,2021.4,2021,Entergy,Debit-Card,-796,-2149,utility,"None,"
10/04/2021,20211004,202110,2021.4,2021,Quest Diagnostics,Debit-Card,930,-1353,health,"None,"
10/04/2021,20211004,202110,2021.4,2021,Hershey,Debit-Card,-337,-2283,grocery,"None,"
10/04/2021,20211004,202110,2021.4,2021,Walmart,Debit-Card,252,-1946,grocery,"None,"
10/01/2021,20211001,202110,2021.39,2021,Tapestry,Debit-Card,968,-2198,clothing,"None,"
09/30/2021,20210930,202109,2021.39,2021,Amazon.com,Debit-Card,-64,-3166,misc,"None,"
09/29/2021,20210929,202109,2021.39,2021,Sysco,Debit-Card,191,-3102,misc,"None,"
09/29/2021,20210929,202109,2021.39,2021,Hanesbrands,Debit-Card,-912,-3293,unk,"None,"
09/28/2021,20210928,202109,2021.39,2021,Hanesbrands,Debit-Card,-24,-2381,unk,"None,"
09/27/2021,20210927,202109,2021.39,2021,Amazon.com,Debit-Card,105,-2357,misc,"None,"
09/27/2021,20210927,202109,2021.39,2021,Visa,Debit-Card,-400,-2462,debt,"None,"
09/27/2021,20210927,202109,2021.39,2021,Delta Air Lines,Debit-Card,-695,-2062,travel,"None,"
09/27/2021,20210927,202109,2021.39,2021,Amazon.com,Debit-Card,-381,-1367,misc,"None,"
09/27/2021,20210927,202109,2021.39,2021,Hewlett Packard Enterprise,Debit-Card,-269,-986,tech,"None,"
09/24/2021,20210924,202109,2021.38,2021,Delta Air Lines,Debit-Card,-866,-717,travel,"None,"
09/24/2021,20210924,202109,2021.38,2021,TIAA,Debit-Card,-840,149,unk,"None,"
09/22/2021,20210922,202109,2021.38,2021,Cognizant Technology Solutions,Debit-Card,746,989,tech,"None,"
09/21/2021,20210921,202109,2021.38,2021,Voya Financial,Debit-Card,-712,243,invest,"None,"
09/21/2021,20210921,202109,2021.38,2021,TIAA,Debit-Card,277,955,unk,"None,"
09/21/2021,20210921,202109,2021.38,2021,Sysco,Debit-Card,469,678,misc,"None,"
09/21/2021,20210921,202109,2021.38,2021,Tapestry,Debit-Card,705,209,clothing,"None,"
09/21/2021,20210921,202109,2021.38,2021,Delta Air Lines,Debit-Card,-293,-496,travel,"None,"
09/20/2021,20210920,202109,2021.38,2021,Voya Financial,Debit-Card,491,-203,invest,"None,"
09/20/2021,20210920,202109,2021.38,2021,Voya Financial,Debit-Card,828,-694,invest,"None,"
09/20/2021,20210920,202109,2021.38,2021,Hewlett Packard Enterprise,Debit-Card,692,-1522,tech,"None,"
09/20/2021,20210920,202109,2021.38,2021,TIAA,Debit-Card,-228,-2214,unk,"None,"
09/20/2021,20210920,202109,2021.38,2021,Entergy,Debit-Card,-371,-1986,utility,"None,"
09/20/2021,20210920,202109,2021.38,2021,Quest Diagnostics,Debit-Card,62,-1615,health,"None,"
09/20/2021,20210920,202109,2021.38,2021,Sysco,Debit-Card,-324,-1677,misc,"None,"
09/17/2021,20210917,202109,2021.37,2021,United Continental Holdings,Debit-Card,-187,-1353,invest,"None,"
09/16/2021,20210916,202109,2021.37,2021,Omnicom Group,Debit-Card,-329,-1166,health,"None,"
09/16/2021,20210916,202109,2021.37,2021,Voya Financial,Debit-Card,919,-837,invest,"None,"
09/15/2021,20210915,202109,2021.37,2021,Walmart,Debit-Card,701,-1756,grocery,"None,"
09/15/2021,20210915,202109,2021.37,2021,Travelers,Debit-Card,356,-2457,travel,"None,"
09/13/2021,20210913,202109,2021.37,2021,Hanesbrands,Debit-Card,250,-2813,unk,"None,"
09/13/2021,20210913,202109,2021.37,2021,Hershey,Debit-Card,215,-3063,grocery,"None,"
09/13/2021,20210913,202109,2021.37,2021,PPL,Debit-Card,26,-3278,paypal,"None,"
09/13/2021,20210913,202109,2021.37,2021,Tapestry,Debit-Card,831,-3304,clothing,"None,"
09/10/2021,20210910,202109,2021.36,2021,TIAA,Debit-Card,-380,-4135,unk,"None,"
09/10/2021,20210910,202109,2021.36,2021,Visa,Debit-Card,-176,-3755,debt,"None,"
09/09/2021,20210909,202109,2021.36,2021,Amazon.com,Debit-Card,-463,-3579,misc,"None,"
09/07/2021,20210907,202109,2021.36,2021,Amazon.com,Debit-Card,-870,-3116,misc,"None,"
09/07/2021,20210907,202109,2021.36,2021,Hewlett Packard Enterprise,Debit-Card,-783,-2246,tech,"None,"
09/07/2021,20210907,202109,2021.36,2021,Sysco,Debit-Card,801,-1463,misc,"None,"
09/07/2021,20210907,202109,2021.36,2021,Travelers,Debit-Card,723,-2264,travel,"None,"
09/07/2021,20210907,202109,2021.36,2021,Voya Financial,Debit-Card,-671,-2987,invest,"None,"
09/07/2021,20210907,202109,2021.36,2021,Hanesbrands,Debit-Card,222,-2316,unk,"None,"
09/07/2021,20210907,202109,2021.36,2021,Hewlett Packard Enterprise,Debit-Card,816,-2538,tech,"None,"
09/03/2021,20210903,202109,2021.35,2021,Travelers,Debit-Card,617,-3354,travel,"None,"
09/03/2021,20210903,202109,2021.35,2021,PPL,Debit-Card,114,-3971,paypal,"None,"
09/03/2021,20210903,202109,2021.35,2021,Delta Air Lines,Debit-Card,-358,-4085,travel,"None,"
09/02/2021,20210902,202109,2021.35,2021,Amazon.com,Debit-Card,272,-3727,misc,"None,"
09/01/2021,20210901,202109,2021.35,2021,Entergy,Debit-Card,-100,-3999,utility,"None,"
09/01/2021,20210901,202109,2021.35,2021,Entergy,Debit-Card,-399,-3899,utility,"None,"
09/01/2021,20210901,202109,2021.35,2021,Travelers,Debit-Card,-726,-3500,travel,"None,"
08/31/2021,20210831,202108,2021.35,2021,Hershey,Debit-Card,510,-2774,grocery,"None,"
08/30/2021,20210830,202108,2021.35,2021,Tapestry,Debit-Card,163,-3284,clothing,"None,"
08/30/2021,20210830,202108,2021.35,2021,Hanesbrands,Debit-Card,801,-3447,unk,"None,"
08/30/2021,20210830,202108,2021.35,2021,Tapestry,Debit-Card,59,-4248,clothing,"None,"
08/30/2021,20210830,202108,2021.35,2021,Visa,Debit-Card,-538,-4307,debt,"None,"
08/27/2021,20210827,202108,2021.34,2021,Sysco,Debit-Card,-844,-3769,misc,"None,"
08/27/2021,20210827,202108,2021.34,2021,Hershey,Debit-Card,-665,-2925,grocery,"None,"
08/26/2021,20210826,202108,2021.34,2021,Sysco,Debit-Card,671,-2260,misc,"None,"
08/25/2021,20210825,202108,2021.34,2021,Voya Financial,Debit-Card,-64,-2931,invest,"None,"
08/25/2021,20210825,202108,2021.34,2021,Voya Financial,Debit-Card,638,-2867,invest,"None,"
08/24/2021,20210824,202108,2021.34,2021,Ulta Beauty,Debit-Card,871,-3505,health,"None,"
08/24/2021,20210824,202108,2021.34,2021,Omnicom Group,Debit-Card,-977,-4376,health,"None,"
08/24/2021,20210824,202108,2021.34,2021,Ulta Beauty,Debit-Card,-20,-3399,health,"None,"
08/24/2021,20210824,202108,2021.34,2021,TIAA,Debit-Card,-171,-3379,unk,"None,"
08/24/2021,20210824,202108,2021.34,2021,Tapestry,Debit-Card,982,-3208,clothing,"None,"
08/23/2021,20210823,202108,2021.34,2021,Walmart,Debit-Card,224,-4190,grocery,"None,"
08/23/2021,20210823,202108,2021.34,2021,Cognizant Technology Solutions,Debit-Card,680,-4414,tech,"None,"
08/23/2021,20210823,202108,2021.34,2021,Entergy,Debit-Card,-405,-5094,utility,"None,"
08/23/2021,20210823,202108,2021.34,2021,Voya Financial,Debit-Card,289,-4689,invest,"None,"
08/20/2021,20210820,202108,2021.33,2021,Hershey,Debit-Card,-799,-4978,grocery,"None,"
08/20/2021,20210820,202108,2021.33,2021,Delta Air Lines,Debit-Card,-531,-4179,travel,"None,"
08/20/2021,20210820,202108,2021.33,2021,CBRE Group,Debit-Card,-734,-3648,invest,"None,"
08/20/2021,20210820,202108,2021.33,2021,Amazon.com,Debit-Card,-978,-2914,misc,"None,"
08/20/2021,20210820,202108,2021.33,2021,Sysco,Debit-Card,917,-1936,misc,"None,"
08/19/2021,20210819,202108,2021.33,2021,CBRE Group,Debit-Card,-393,-2853,invest,"None,"
08/18/2021,20210818,202108,2021.33,2021,PPL,Debit-Card,485,-2460,paypal,"None,"
08/18/2021,20210818,202108,2021.33,2021,Walmart,Debit-Card,574,-2945,grocery,"None,"
08/17/2021,20210817,202108,2021.33,2021,Ulta Beauty,Debit-Card,-846,-3519,health,"None,"
08/17/2021,20210817,202108,2021.33,2021,Visa,Debit-Card,-594,-2673,debt,"None,"
08/17/2021,20210817,202108,2021.33,2021,Sysco,Debit-Card,-780,-2079,misc,"None,"
08/16/2021,20210816,202108,2021.33,2021,PPL,Debit-Card,395,-1299,paypal,"None,"
08/13/2021,20210813,202108,2021.32,2021,Quest Diagnostics,Debit-Card,-82,-1694,health,"None,"
08/13/2021,20210813,202108,2021.32,2021,Quest Diagnostics,Debit-Card,-98,-1612,health,"None,"
08/13/2021,20210813,202108,2021.32,2021,Omnicom Group,Debit-Card,583,-1514,health,"None,"
08/12/2021,20210812,202108,2021.32,2021,Entergy,Debit-Card,61,-2097,utility,"None,"
08/12/2021,20210812,202108,2021.32,2021,Sysco,Debit-Card,-38,-2158,misc,"None,"
08/12/2021,20210812,202108,2021.32,2021,Walmart,Debit-Card,-444,-2120,grocery,"None,"
08/12/2021,20210812,202108,2021.32,2021,Tapestry,Debit-Card,-190,-1676,clothing,"None,"
08/12/2021,20210812,202108,2021.32,2021,Entergy,Debit-Card,-846,-1486,utility,"None,"
08/11/2021,20210811,202108,2021.32,2021,Hanesbrands,Debit-Card,-670,-640,unk,"None,"
08/10/2021,20210810,202108,2021.32,2021,TIAA,Debit-Card,718,30,unk,"None,"
08/10/2021,20210810,202108,2021.32,2021,PPL,Debit-Card,-595,-688,paypal,"None,"
08/09/2021,20210809,202108,2021.32,2021,Amazon.com,Debit-Card,-974,-93,misc,"None,"
08/09/2021,20210809,202108,2021.32,2021,Ulta Beauty,Debit-Card,-858,881,health,"None,"
08/09/2021,20210809,202108,2021.32,2021,Ulta Beauty,Debit-Card,792,1739,health,"None,"
08/09/2021,20210809,202108,2021.32,2021,Hewlett Packard Enterprise,Debit-Card,-757,947,tech,"None,"
08/09/2021,20210809,202108,2021.32,2021,Tapestry,Debit-Card,161,1704,clothing,"None,"
08/09/2021,20210809,202108,2021.32,2021,Tapestry,Debit-Card,-940,1543,clothing,"None,"
08/09/2021,20210809,202108,2021.32,2021,Hewlett Packard Enterprise,Debit-Card,-966,2483,tech,"None,"
08/05/2021,20210805,202108,2021.31,2021,Visa,Debit-Card,-539,3449,debt,"None,"
08/04/2021,20210804,202108,2021.31,2021,United Continental Holdings,Debit-Card,-56,3988,invest,"None,"
08/03/2021,20210803,202108,2021.31,2021,United Continental Holdings,Debit-Card,-292,4044,invest,"None,"
08/02/2021,20210802,202108,2021.31,2021,Tapestry,Debit-Card,-663,4336,clothing,"None,"
08/02/2021,20210802,202108,2021.31,2021,Hershey,Debit-Card,449,4999,grocery,"None,"
08/02/2021,20210802,202108,2021.31,2021,Sysco,Debit-Card,6,4550,misc,"None,"
08/02/2021,20210802,202108,2021.31,2021,Hanesbrands,Debit-Card,-573,4544,unk,"None,"
08/02/2021,20210802,202108,2021.31,2021,Sysco,Debit-Card,434,5117,misc,"None,"
08/02/2021,20210802,202108,2021.31,2021,Delta Air Lines,Debit-Card,748,4683,travel,"None,"
07/30/2021,20210730,202107,2021.3,2021,Delta Air Lines,Debit-Card,653,3935,travel,"None,"
07/30/2021,20210730,202107,2021.3,2021,Delta Air Lines,Debit-Card,-673,3282,travel,"None,"
07/30/2021,20210730,202107,2021.3,2021,Quest Diagnostics,Debit-Card,523,3955,health,"None,"
07/30/2021,20210730,202107,2021.3,2021,Entergy,Debit-Card,286,3432,utility,"None,"
07/28/2021,20210728,202107,2021.3,2021,Travelers,Debit-Card,880,3146,travel,"None,"
07/27/2021,20210727,202107,2021.3,2021,Walmart,Debit-Card,-236,2266,grocery,"None,"
07/27/2021,20210727,202107,2021.3,2021,Cognizant Technology Solutions,Debit-Card,732,2502,tech,"None,"
07/26/2021,20210726,202107,2021.3,2021,Sysco,Debit-Card,-582,1770,misc,"None,"
07/26/2021,20210726,202107,2021.3,2021,Hanesbrands,Debit-Card,453,2352,unk,"None,"
07/26/2021,20210726,202107,2021.3,2021,Delta Air Lines,Debit-Card,-36,1899,travel,"None,"
07/26/2021,20210726,202107,2021.3,2021,Delta Air Lines,Debit-Card,609,1935,travel,"None,"
07/23/2021,20210723,202107,2021.29,2021,Hewlett Packard Enterprise,Debit-Card,-186,1326,tech,"None,"
07/22/2021,20210722,202107,2021.29,2021,Travelers,Debit-Card,-932,1512,travel,"None,"
07/22/2021,20210722,202107,2021.29,2021,Delta Air Lines,Debit-Card,767,2444,travel,"None,"
07/21/2021,20210721,202107,2021.29,2021,United Continental Holdings,Debit-Card,108,1677,invest,"None,"
07/21/2021,20210721,202107,2021.29,2021,Delta Air Lines,Debit-Card,-998,1569,travel,"None,"
07/21/2021,20210721,202107,2021.29,2021,Hewlett Packard Enterprise,Debit-Card,-70,2567,tech,"None,"
07/20/2021,20210720,202107,2021.29,2021,Voya Financial,Debit-Card,-887,2637,invest,"None,"
07/19/2021,20210719,202107,2021.29,2021,TIAA,Debit-Card,-806,3524,unk,"None,"
07/19/2021,20210719,202107,2021.29,2021,Delta Air Lines,Debit-Card,-552,4330,travel,"None,"
07/19/2021,20210719,202107,2021.29,2021,Omnicom Group,Debit-Card,-948,4882,health,"None,"
07/19/2021,20210719,202107,2021.29,2021,Voya Financial,Debit-Card,324,5830,invest,"None,"
07/19/2021,20210719,202107,2021.29,2021,Omnicom Group,Debit-Card,-329,5506,health,"None,"
07/19/2021,20210719,202107,2021.29,2021,Entergy,Debit-Card,235,5835,utility,"None,"
07/19/2021,20210719,202107,2021.29,2021,PPL,Debit-Card,533,5600,paypal,"None,"
07/19/2021,20210719,202107,2021.29,2021,TIAA,Debit-Card,734,5067,unk,"None,"
07/16/2021,20210716,202107,2021.28,2021,Walmart,Debit-Card,369,4333,grocery,"None,"
07/15/2021,20210715,202107,2021.28,2021,Quest Diagnostics,Debit-Card,-992,3964,health,"None,"
07/15/2021,20210715,202107,2021.28,2021,TIAA,Debit-Card,402,4956,unk,"None,"
07/15/2021,20210715,202107,2021.28,2021,Voya Financial,Debit-Card,-324,4554,invest,"None,"
07/13/2021,20210713,202107,2021.28,2021,Hershey,Debit-Card,321,4878,grocery,"None,"
07/13/2021,20210713,202107,2021.28,2021,Hewlett Packard Enterprise,Debit-Card,-915,4557,tech,"None,"
07/12/2021,20210712,202107,2021.28,2021,Cognizant Technology Solutions,Debit-Card,155,5472,tech,"None,"
07/12/2021,20210712,202107,2021.28,2021,Quest Diagnostics,Debit-Card,197,5317,health,"None,"
07/12/2021,20210712,202107,2021.28,2021,Omnicom Group,Debit-Card,529,5120,health,"None,"
07/12/2021,20210712,202107,2021.28,2021,Voya Financial,Debit-Card,204,4591,invest,"None,"
07/12/2021,20210712,202107,2021.28,2021,CBRE Group,Debit-Card,-602,4387,invest,"None,"
07/12/2021,20210712,202107,2021.28,2021,Visa,Debit-Card,-343,4989,debt,"None,"
07/12/2021,20210712,202107,2021.28,2021,PPL,Debit-Card,-870,5332,paypal,"None,"
07/09/2021,20210709,202107,2021.27,2021,Hanesbrands,Debit-Card,155,6202,unk,"None,"
07/08/2021,20210708,202107,2021.27,2021,Visa,Debit-Card,-433,6047,debt,"None,"
07/08/2021,20210708,202107,2021.27,2021,Cognizant Technology Solutions,Debit-Card,-596,6480,tech,"None,"
07/08/2021,20210708,202107,2021.27,2021,Walmart,Debit-Card,-46,7076,grocery,"None,"
07/07/2021,20210707,202107,2021.27,2021,Hershey,Debit-Card,-811,7122,grocery,"None,"
07/07/2021,20210707,202107,2021.27,2021,United Continental Holdings,Debit-Card,572,7933,invest,"None,"
07/06/2021,20210706,202107,2021.27,2021,Travelers,Debit-Card,-83,7361,travel,"None,"
07/06/2021,20210706,202107,2021.27,2021,CBRE Group,Debit-Card,-245,7444,invest,"None,"
07/06/2021,20210706,202107,2021.27,2021,Delta Air Lines,Debit-Card,-439,7689,travel,"None,"
07/06/2021,20210706,202107,2021.27,2021,United Continental Holdings,Debit-Card,-504,8128,invest,"None,"
07/06/2021,20210706,202107,2021.27,2021,Amazon.com,Debit-Card,23,8632,misc,"None,"
07/06/2021,20210706,202107,2021.27,2021,Visa,Debit-Card,-108,8609,debt,"None,"
07/06/2021,20210706,202107,2021.27,2021,Hewlett Packard Enterprise,Debit-Card,-929,8717,tech,"None,"
07/02/2021,20210702,202107,2021.26,2021,Travelers,Debit-Card,258,9646,travel,"None,"
07/02/2021,20210702,202107,2021.26,2021,Hanesbrands,Debit-Card,-211,9388,unk,"None,"
07/02/2021,20210702,202107,2021.26,2021,Visa,Debit-Card,964,9599,debt,"None,"
07/01/2021,20210701,202107,2021.26,2021,Ulta Beauty,Debit-Card,701,8635,health,"None,"
07/01/2021,20210701,202107,2021.26,2021,Travelers,Debit-Card,-351,7934,travel,"None,"
06/30/2021,20210630,202106,2021.26,2021,TIAA,Debit-Card,-694,8285,unk,"None,"
06/28/2021,20210628,202106,2021.26,2021,United Continental Holdings,Debit-Card,-613,8979,invest,"None,"
06/28/2021,20210628,202106,2021.26,2021,Voya Financial,Debit-Card,-560,9592,invest,"None,"
06/28/2021,20210628,202106,2021.26,2021,Visa,Debit-Card,-832,10152,debt,"None,"
06/28/2021,20210628,202106,2021.26,2021,CBRE Group,Debit-Card,-68,10984,invest,"None,"
06/28/2021,20210628,202106,2021.26,2021,Hewlett Packard Enterprise,Debit-Card,-463,11052,tech,"None,"
06/28/2021,20210628,202106,2021.26,2021,Hanesbrands,Debit-Card,820,11515,unk,"None,"
06/25/2021,20210625,202106,2021.25,2021,Cognizant Technology Solutions,Debit-Card,-388,10695,tech,"None,"
06/25/2021,20210625,202106,2021.25,2021,Hewlett Packard Enterprise,Debit-Card,-226,11083,tech,"None,"
06/25/2021,20210625,202106,2021.25,2021,TIAA,Debit-Card,688,11309,unk,"None,"
06/25/2021,20210625,202106,2021.25,2021,Hershey,Debit-Card,-572,10621,grocery,"None,"
06/24/2021,20210624,202106,2021.25,2021,Amazon.com,Debit-Card,746,11193,misc,"None,"
06/24/2021,20210624,202106,2021.25,2021,Entergy,Debit-Card,-101,10447,utility,"None,"
06/24/2021,20210624,202106,2021.25,2021,TIAA,Debit-Card,484,10548,unk,"None,"
06/23/2021,20210623,202106,2021.25,2021,Sysco,Debit-Card,697,10064,misc,"None,"
06/22/2021,20210622,202106,2021.25,2021,Visa,Debit-Card,699,9367,debt,"None,"
06/21/2021,20210621,202106,2021.25,2021,TIAA,Debit-Card,-216,8668,unk,"None,"
06/21/2021,20210621,202106,2021.25,2021,Travelers,Debit-Card,155,8884,travel,"None,"
06/21/2021,20210621,202106,2021.25,2021,Sysco,Debit-Card,874,8729,misc,"None,"
06/21/2021,20210621,202106,2021.25,2021,Amazon.com,Debit-Card,740,7855,misc,"None,"
06/21/2021,20210621,202106,2021.25,2021,Cognizant Technology Solutions,Debit-Card,-488,7115,tech,"None,"
06/21/2021,20210621,202106,2021.25,2021,Delta Air Lines,Debit-Card,682,7603,travel,"None,"
06/21/2021,20210621,202106,2021.25,2021,CBRE Group,Debit-Card,801,6921,invest,"None,"
06/21/2021,20210621,202106,2021.25,2021,Quest Diagnostics,Debit-Card,5,6120,health,"None,"
06/21/2021,20210621,202106,2021.25,2021,Voya Financial,Debit-Card,992,6115,invest,"None,"
06/18/2021,20210618,202106,2021.24,2021,Amazon.com,Debit-Card,-787,5123,misc,"None,"
06/18/2021,20210618,202106,2021.24,2021,Amazon.com,Debit-Card,-717,5910,misc,"None,"
06/18/2021,20210618,202106,2021.24,2021,CBRE Group,Debit-Card,28,6627,invest,"None,"
06/18/2021,20210618,202106,2021.24,2021,Ulta Beauty,Debit-Card,831,6599,health,"None,"
06/18/2021,20210618,202106,2021.24,2021,Walmart,Debit-Card,652,5768,grocery,"None,"
06/18/2021,20210618,202106,2021.24,2021,Omnicom Group,Debit-Card,-519,5116,health,"None,"
06/17/2021,20210617,202106,2021.24,2021,Visa,Debit-Card,-673,5635,debt,"None,"
06/17/2021,20210617,202106,2021.24,2021,Visa,Debit-Card,816,6308,debt,"None,"
06/17/2021,20210617,202106,2021.24,2021,Tapestry,Debit-Card,-322,5492,clothing,"None,"
06/17/2021,20210617,202106,2021.24,2021,Tapestry,Debit-Card,-72,5814,clothing,"None,"
06/17/2021,20210617,202106,2021.24,2021,Walmart,Debit-Card,890,5886,grocery,"None,"
06/15/2021,20210615,202106,2021.24,2021,Tapestry,Debit-Card,-453,4996,clothing,"None,"
06/15/2021,20210615,202106,2021.24,2021,Amazon.com,Debit-Card,-922,5449,misc,"None,"
06/15/2021,20210615,202106,2021.24,2021,Amazon.com,Debit-Card,-885,6371,misc,"None,"
06/14/2021,20210614,202106,2021.24,2021,Tapestry,Debit-Card,920,7256,clothing,"None,"
06/14/2021,20210614,202106,2021.24,2021,Hershey,Debit-Card,-266,6336,grocery,"None,"
06/11/2021,20210611,202106,2021.23,2021,PPL,Debit-Card,-786,6602,paypal,"None,"
06/11/2021,20210611,202106,2021.23,2021,PPL,Debit-Card,-272,7388,paypal,"None,"
06/11/2021,20210611,202106,2021.23,2021,TIAA,Debit-Card,-249,7660,unk,"None,"
06/11/2021,20210611,202106,2021.23,2021,Hewlett Packard Enterprise,Debit-Card,475,7909,tech,"None,"
06/10/2021,20210610,202106,2021.23,2021,Hewlett Packard Enterprise,Debit-Card,-50,7434,tech,"None,"
06/10/2021,20210610,202106,2021.23,2021,Voya Financial,Debit-Card,206,7484,invest,"None,"
06/10/2021,20210610,202106,2021.23,2021,Visa,Debit-Card,276,7278,debt,"None,"
06/10/2021,20210610,202106,2021.23,2021,Cognizant Technology Solutions,Debit-Card,579,7002,tech,"None,"
06/10/2021,20210610,202106,2021.23,2021,Travelers,Debit-Card,563,6423,travel,"None,"
06/08/2021,20210608,202106,2021.23,2021,United Continental Holdings,Debit-Card,387,5860,invest,"None,"
06/07/2021,20210607,202106,2021.23,2021,Ulta Beauty,Debit-Card,35,5473,health,"None,"
06/07/2021,20210607,202106,2021.23,2021,PPL,Debit-Card,218,5438,paypal,"None,"
06/07/2021,20210607,202106,2021.23,2021,PPL,Debit-Card,539,5220,paypal,"None,"
06/04/2021,20210604,202106,2021.22,2021,Hanesbrands,Debit-Card,29,4681,unk,"None,"
06/04/2021,20210604,202106,2021.22,2021,Hershey,Debit-Card,268,4652,grocery,"None,"
06/03/2021,20210603,202106,2021.22,2021,Cognizant Technology Solutions,Debit-Card,790,4384,tech,"None,"
06/03/2021,20210603,202106,2021.22,2021,Voya Financial,Debit-Card,-842,3594,invest,"None,"
06/02/2021,20210602,202106,2021.22,2021,Ulta Beauty,Debit-Card,-253,4436,health,"None,"
06/01/2021,20210601,202106,2021.22,2021,Walmart,Debit-Card,-640,4689,grocery,"None,"
06/01/2021,20210601,202106,2021.22,2021,Hershey,Debit-Card,-510,5329,grocery,"None,"
06/01/2021,20210601,202106,2021.22,2021,Hanesbrands,Debit-Card,-75,5839,unk,"None,"
06/01/2021,20210601,202106,2021.22,2021,Hanesbrands,Debit-Card,936,5914,unk,"None,"
05/28/2021,20210528,202105,2021.21,2021,Hewlett Packard Enterprise,Debit-Card,-409,4978,tech,"None,"
05/28/2021,20210528,202105,2021.21,2021,Ulta Beauty,Debit-Card,951,5387,health,"None,"
05/28/2021,20210528,202105,2021.21,2021,Delta Air Lines,Debit-Card,536,4436,travel,"None,"
05/28/2021,20210528,202105,2021.21,2021,Travelers,Debit-Card,715,3900,travel,"None,"
05/27/2021,20210527,202105,2021.21,2021,TIAA,Debit-Card,574,3185,unk,"None,"
05/27/2021,20210527,202105,2021.21,2021,Visa,Debit-Card,-825,2611,debt,"None,"
05/26/2021,20210526,202105,2021.21,2021,TIAA,Debit-Card,-677,3436,unk,"None,"
05/26/2021,20210526,202105,2021.21,2021,Hewlett Packard Enterprise,Debit-Card,-983,4113,tech,"None,"
05/25/2021,20210525,202105,2021.21,2021,Cognizant Technology Solutions,Debit-Card,570,5096,tech,"None,"
05/24/2021,20210524,202105,2021.21,2021,Voya Financial,Debit-Card,423,4526,invest,"None,"
05/24/2021,20210524,202105,2021.21,2021,Entergy,Debit-Card,640,4103,utility,"None,"
05/24/2021,20210524,202105,2021.21,2021,Hanesbrands,Debit-Card,-14,3463,unk,"None,"
05/24/2021,20210524,202105,2021.21,2021,CBRE Group,Debit-Card,-432,3477,invest,"None,"
05/24/2021,20210524,202105,2021.21,2021,Visa,Debit-Card,-752,3909,debt,"None,"
05/21/2021,20210521,202105,2021.2,2021,Hanesbrands,Debit-Card,972,4661,unk,"None,"
05/21/2021,20210521,202105,2021.2,2021,Visa,Debit-Card,857,3689,debt,"None,"
05/21/2021,20210521,202105,2021.2,2021,Omnicom Group,Debit-Card,-988,2832,health,"None,"
05/21/2021,20210521,202105,2021.2,2021,Delta Air Lines,Debit-Card,382,3820,travel,"None,"
05/21/2021,20210521,202105,2021.2,2021,Hanesbrands,Debit-Card,-168,3438,unk,"None,"
05/21/2021,20210521,202105,2021.2,2021,Hershey,Debit-Card,487,3606,grocery,"None,"
05/20/2021,20210520,202105,2021.2,2021,Tapestry,Debit-Card,226,3119,clothing,"None,"
05/20/2021,20210520,202105,2021.2,2021,Entergy,Debit-Card,638,2893,utility,"None,"
05/19/2021,20210519,202105,2021.2,2021,Omnicom Group,Debit-Card,133,2255,health,"None,"
05/18/2021,20210518,202105,2021.2,2021,TIAA,Debit-Card,354,2122,unk,"None,"
05/18/2021,20210518,202105,2021.2,2021,Entergy,Debit-Card,281,1768,utility,"None,"
05/17/2021,20210517,202105,2021.2,2021,Omnicom Group,Debit-Card,846,1487,health,"None,"
05/17/2021,20210517,202105,2021.2,2021,PPL,Debit-Card,-271,641,paypal,"None,"
05/17/2021,20210517,202105,2021.2,2021,Travelers,Debit-Card,-708,912,travel,"None,"
05/17/2021,20210517,202105,2021.2,2021,Hanesbrands,Debit-Card,-242,1620,unk,"None,"
05/14/2021,20210514,202105,2021.19,2021,Sysco,Debit-Card,536,1862,misc,"None,"
05/14/2021,20210514,202105,2021.19,2021,Delta Air Lines,Debit-Card,-503,1326,travel,"None,"
05/12/2021,20210512,202105,2021.19,2021,Amazon.com,Debit-Card,-802,1829,misc,"None,"
05/11/2021,20210511,202105,2021.19,2021,Walmart,Debit-Card,502,2631,grocery,"None,"
05/10/2021,20210510,202105,2021.19,2021,PPL,Debit-Card,-642,2129,paypal,"None,"
05/10/2021,20210510,202105,2021.19,2021,TIAA,Debit-Card,-219,2771,unk,"None,"
05/10/2021,20210510,202105,2021.19,2021,Sysco,Debit-Card,174,2990,misc,"None,"
05/10/2021,20210510,202105,2021.19,2021,Entergy,Debit-Card,791,2816,utility,"None,"
05/10/2021,20210510,202105,2021.19,2021,Quest Diagnostics,Debit-Card,564,2025,health,"None,"
05/10/2021,20210510,202105,2021.19,2021,Entergy,Debit-Card,-835,1461,utility,"None,"
05/10/2021,20210510,202105,2021.19,2021,Tapestry,Debit-Card,947,2296,clothing,"None,"
05/07/2021,20210507,202105,2021.18,2021,Quest Diagnostics,Debit-Card,-545,1349,health,"None,"
05/06/2021,20210506,202105,2021.18,2021,Hewlett Packard Enterprise,Debit-Card,141,1894,tech,"None,"
05/06/2021,20210506,202105,2021.18,2021,Tapestry,Debit-Card,233,1753,clothing,"None,"
05/05/2021,20210505,202105,2021.18,2021,United Continental Holdings,Debit-Card,-441,1520,invest,"None,"
05/05/2021,20210505,202105,2021.18,2021,Hershey,Debit-Card,514,1961,grocery,"None,"
05/04/2021,20210504,202105,2021.18,2021,Entergy,Debit-Card,17,1447,utility,"None,"
05/04/2021,20210504,202105,2021.18,2021,PPL,Debit-Card,-468,1430,paypal,"None,"
05/03/2021,20210503,202105,2021.18,2021,Visa,Debit-Card,-658,1898,debt,"None,"
05/03/2021,20210503,202105,2021.18,2021,Hershey,Debit-Card,-704,2556,grocery,"None,"
05/03/2021,20210503,202105,2021.18,2021,Amazon.com,Debit-Card,372,3260,misc,"None,"
05/03/2021,20210503,202105,2021.18,2021,Omnicom Group,Debit-Card,-3,2888,health,"None,"
05/03/2021,20210503,202105,2021.18,2021,PPL,Debit-Card,986,2891,paypal,"None,"
05/03/2021,20210503,202105,2021.18,2021,Hershey,Debit-Card,920,1905,grocery,"None,"
05/03/2021,20210503,202105,2021.18,2021,Walmart,Debit-Card,-955,985,grocery,"None,"
04/30/2021,20210430,202104,2021.17,2021,Hershey,Debit-Card,217,1940,grocery,"None,"
04/30/2021,20210430,202104,2021.17,2021,Ulta Beauty,Debit-Card,321,1723,health,"None,"
04/30/2021,20210430,202104,2021.17,2021,TIAA,Debit-Card,-81,1402,unk,"None,"
04/30/2021,20210430,202104,2021.17,2021,Sysco,Debit-Card,-519,1483,misc,"None,"
04/30/2021,20210430,202104,2021.17,2021,Amazon.com,Debit-Card,509,2002,misc,"None,"
04/29/2021,20210429,202104,2021.17,2021,Omnicom Group,Debit-Card,-544,1493,health,"None,"
04/28/2021,20210428,202104,2021.17,2021,Hershey,Debit-Card,330,2037,grocery,"None,"
04/28/2021,20210428,202104,2021.17,2021,Delta Air Lines,Debit-Card,12,1707,travel,"None,"
04/28/2021,20210428,202104,2021.17,2021,Voya Financial,Debit-Card,353,1695,invest,"None,"
04/27/2021,20210427,202104,2021.17,2021,Travelers,Debit-Card,625,1342,travel,"None,"
04/26/2021,20210426,202104,2021.17,2021,Ulta Beauty,Debit-Card,-746,717,health,"None,"
04/26/2021,20210426,202104,2021.17,2021,Hanesbrands,Debit-Card,-725,1463,unk,"None,"
04/26/2021,20210426,202104,2021.17,2021,TIAA,Debit-Card,-396,2188,unk,"None,"
04/26/2021,20210426,202104,2021.17,2021,TIAA,Debit-Card,-840,2584,unk,"None,"
04/26/2021,20210426,202104,2021.17,2021,Cognizant Technology Solutions,Debit-Card,861,3424,tech,"None,"
04/26/2021,20210426,202104,2021.17,2021,Voya Financial,Debit-Card,244,2563,invest,"None,"
04/26/2021,20210426,202104,2021.17,2021,TIAA,Debit-Card,937,2319,unk,"None,"
04/26/2021,20210426,202104,2021.17,2021,Tapestry,Debit-Card,34,1382,clothing,"None,"
04/26/2021,20210426,202104,2021.17,2021,TIAA,Debit-Card,319,1348,unk,"None,"
04/23/2021,20210423,202104,2021.16,2021,Visa,Debit-Card,-407,1029,debt,"None,"
04/23/2021,20210423,202104,2021.16,2021,PPL,Debit-Card,-440,1436,paypal,"None,"
04/23/2021,20210423,202104,2021.16,2021,Amazon.com,Debit-Card,264,1876,misc,"None,"
04/23/2021,20210423,202104,2021.16,2021,Quest Diagnostics,Debit-Card,-432,1612,health,"None,"
04/23/2021,20210423,202104,2021.16,2021,Visa,Debit-Card,703,2044,debt,"None,"
04/22/2021,20210422,202104,2021.16,2021,Delta Air Lines,Debit-Card,34,1341,travel,"None,"
04/22/2021,20210422,202104,2021.16,2021,Walmart,Debit-Card,-364,1307,grocery,"None,"
04/21/2021,20210421,202104,2021.16,2021,Visa,Debit-Card,612,1671,debt,"None,"
04/21/2021,20210421,202104,2021.16,2021,Sysco,Debit-Card,-425,1059,misc,"None,"
04/21/2021,20210421,202104,2021.16,2021,Amazon.com,Debit-Card,-510,1484,misc,"None,"
04/20/2021,20210420,202104,2021.16,2021,Hanesbrands,Debit-Card,-489,1994,unk,"None,"
04/20/2021,20210420,202104,2021.16,2021,Amazon.com,Debit-Card,532,2483,misc,"None,"
04/20/2021,20210420,202104,2021.16,2021,Entergy,Debit-Card,-310,1951,utility,"None,"
04/20/2021,20210420,202104,2021.16,2021,Visa,Debit-Card,13,2261,debt,"None,"
04/19/2021,20210419,202104,2021.16,2021,Tapestry,Debit-Card,-899,2248,clothing,"None,"
04/19/2021,20210419,202104,2021.16,2021,Cognizant Technology Solutions,Debit-Card,234,3147,tech,"None,"
04/19/2021,20210419,202104,2021.16,2021,CBRE Group,Debit-Card,742,2913,invest,"None,"
04/19/2021,20210419,202104,2021.16,2021,Cognizant Technology Solutions,Debit-Card,-407,2171,tech,"None,"
04/19/2021,20210419,202104,2021.16,2021,Omnicom Group,Debit-Card,-891,2578,health,"None,"
04/19/2021,20210419,202104,2021.16,2021,United Continental Holdings,Debit-Card,807,3469,invest,"None,"
04/19/2021,20210419,202104,2021.16,2021,Tapestry,Debit-Card,-937,2662,clothing,"None,"
04/19/2021,20210419,202104,2021.16,2021,TIAA,Debit-Card,-586,3599,unk,"None,"
04/19/2021,20210419,202104,2021.16,2021,PPL,Debit-Card,-449,4185,paypal,"None,"
04/19/2021,20210419,202104,2021.16,2021,Amazon.com,Debit-Card,-612,4634,misc,"None,"
04/19/2021,20210419,202104,2021.16,2021,TIAA,Debit-Card,381,5246,unk,"None,"
04/16/2021,20210416,202104,2021.15,2021,Tapestry,Debit-Card,636,4865,clothing,"None,"
04/16/2021,20210416,202104,2021.15,2021,PPL,Debit-Card,-151,4229,paypal,"None,"
04/16/2021,20210416,202104,2021.15,2021,Sysco,Debit-Card,331,4380,misc,"None,"
04/15/2021,20210415,202104,2021.15,2021,United Continental Holdings,Debit-Card,930,4049,invest,"None,"
04/14/2021,20210414,202104,2021.15,2021,Delta Air Lines,Debit-Card,-451,3119,travel,"None,"
04/14/2021,20210414,202104,2021.15,2021,Visa,Debit-Card,-747,3570,debt,"None,"
04/14/2021,20210414,202104,2021.15,2021,Entergy,Debit-Card,-45,4317,utility,"None,"
04/13/2021,20210413,202104,2021.15,2021,Travelers,Debit-Card,-387,4362,travel,"None,"
04/12/2021,20210412,202104,2021.15,2021,Hershey,Debit-Card,693,4749,grocery,"None,"
04/12/2021,20210412,202104,2021.15,2021,Delta Air Lines,Debit-Card,-89,4056,travel,"None,"
04/12/2021,20210412,202104,2021.15,2021,Entergy,Debit-Card,-704,4145,utility,"None,"
04/12/2021,20210412,202104,2021.15,2021,Voya Financial,Debit-Card,-190,4849,invest,"None,"
04/12/2021,20210412,202104,2021.15,2021,Hewlett Packard Enterprise,Debit-Card,-827,5039,tech,"None,"
04/12/2021,20210412,202104,2021.15,2021,Hershey,Debit-Card,826,5866,grocery,"None,"
04/12/2021,20210412,202104,2021.15,2021,Walmart,Debit-Card,536,5040,grocery,"None,"
04/12/2021,20210412,202104,2021.15,2021,PPL,Debit-Card,900,4504,paypal,"None,"
04/12/2021,20210412,202104,2021.15,2021,Entergy,Debit-Card,222,3604,utility,"None,"
04/12/2021,20210412,202104,2021.15,2021,Amazon.com,Debit-Card,-441,3382,misc,"None,"
04/09/2021,20210409,202104,2021.14,2021,Amazon.com,Debit-Card,-745,3823,misc,"None,"
04/08/2021,20210408,202104,2021.14,2021,Visa,Debit-Card,-163,4568,debt,"None,"
04/07/2021,20210407,202104,2021.14,2021,United Continental Holdings,Debit-Card,697,4731,invest,"None,"
04/06/2021,20210406,202104,2021.14,2021,Travelers,Debit-Card,648,4034,travel,"None,"
04/06/2021,20210406,202104,2021.14,2021,Voya Financial,Debit-Card,-850,3386,invest,"None,"
04/05/2021,20210405,202104,2021.14,2021,Hanesbrands,Debit-Card,277,4236,unk,"None,"
04/05/2021,20210405,202104,2021.14,2021,Sysco,Debit-Card,738,3959,misc,"None,"
04/02/2021,20210402,202104,2021.13,2021,Quest Diagnostics,Debit-Card,596,3221,health,"None,"
04/02/2021,20210402,202104,2021.13,2021,PPL,Debit-Card,-287,2625,paypal,"None,"
04/02/2021,20210402,202104,2021.13,2021,Sysco,Debit-Card,892,2912,misc,"None,"
04/02/2021,20210402,202104,2021.13,2021,United Continental Holdings,Debit-Card,-400,2020,invest,"None,"
04/01/2021,20210401,202104,2021.13,2021,Omnicom Group,Debit-Card,7,2420,health,"None,"
03/31/2021,20210331,202103,2021.13,2021,Hershey,Debit-Card,767,2413,grocery,"None,"
03/31/2021,20210331,202103,2021.13,2021,Sysco,Debit-Card,466,1646,misc,"None,"
03/29/2021,20210329,202103,2021.13,2021,Ulta Beauty,Debit-Card,747,1180,health,"None,"
03/29/2021,20210329,202103,2021.13,2021,Cognizant Technology Solutions,Debit-Card,601,433,tech,"None,"
03/29/2021,20210329,202103,2021.13,2021,Hewlett Packard Enterprise,Debit-Card,878,-168,tech,"None,"
03/24/2021,20210324,202103,2021.12,2021,Hanesbrands,Debit-Card,520,-1046,unk,"None,"
03/23/2021,20210323,202103,2021.12,2021,United Continental Holdings,Debit-Card,941,-1566,invest,"None,"
03/22/2021,20210322,202103,2021.12,2021,Hewlett Packard Enterprise,Debit-Card,74,-2507,tech,"None,"
03/22/2021,20210322,202103,2021.12,2021,Visa,Debit-Card,931,-2581,debt,"None,"
03/22/2021,20210322,202103,2021.12,2021,Walmart,Debit-Card,-581,-3512,grocery,"None,"
03/19/2021,20210319,202103,2021.11,2021,Sysco,Debit-Card,-394,-2931,misc,"None,"
03/19/2021,20210319,202103,2021.11,2021,Delta Air Lines,Debit-Card,-338,-2537,travel,"None,"
03/19/2021,20210319,202103,2021.11,2021,Hershey,Debit-Card,-774,-2199,grocery,"None,"
03/18/2021,20210318,202103,2021.11,2021,Amazon.com,Debit-Card,692,-1425,misc,"None,"
03/18/2021,20210318,202103,2021.11,2021,Cognizant Technology Solutions,Debit-Card,674,-2117,tech,"None,"
03/17/2021,20210317,202103,2021.11,2021,United Continental Holdings,Debit-Card,-323,-2791,invest,"None,"
03/16/2021,20210316,202103,2021.11,2021,Omnicom Group,Debit-Card,-624,-2468,health,"None,"
03/15/2021,20210315,202103,2021.11,2021,Omnicom Group,Debit-Card,467,-1844,health,"None,"
03/15/2021,20210315,202103,2021.11,2021,Hanesbrands,Debit-Card,447,-2311,unk,"None,"
03/15/2021,20210315,202103,2021.11,2021,Cognizant Technology Solutions,Debit-Card,-493,-2758,tech,"None,"
03/15/2021,20210315,202103,2021.11,2021,Walmart,Debit-Card,842,-2265,grocery,"None,"
03/15/2021,20210315,202103,2021.11,2021,Sysco,Debit-Card,-293,-3107,misc,"None,"
03/15/2021,20210315,202103,2021.11,2021,Cognizant Technology Solutions,Debit-Card,-470,-2814,tech,"None,"
03/15/2021,20210315,202103,2021.11,2021,Delta Air Lines,Debit-Card,404,-2344,travel,"None,"
03/15/2021,20210315,202103,2021.11,2021,United Continental Holdings,Debit-Card,-524,-2748,invest,"None,"
03/12/2021,20210312,202103,2021.1,2021,Voya Financial,Debit-Card,535,-2224,invest,"None,"
03/11/2021,20210311,202103,2021.1,2021,Omnicom Group,Debit-Card,-34,-2759,health,"None,"
03/11/2021,20210311,202103,2021.1,2021,PPL,Debit-Card,54,-2725,paypal,"None,"
03/11/2021,20210311,202103,2021.1,2021,TIAA,Debit-Card,943,-2779,unk,"None,"
03/10/2021,20210310,202103,2021.1,2021,Sysco,Debit-Card,-635,-3722,misc,"None,"
03/10/2021,20210310,202103,2021.1,2021,Entergy,Debit-Card,870,-3087,utility,"None,"
03/08/2021,20210308,202103,2021.1,2021,Quest Diagnostics,Debit-Card,195,-3957,health,"None,"
03/08/2021,20210308,202103,2021.1,2021,Hanesbrands,Debit-Card,-399,-4152,unk,"None,"
03/08/2021,20210308,202103,2021.1,2021,United Continental Holdings,Debit-Card,-981,-3753,invest,"None,"
03/08/2021,20210308,202103,2021.1,2021,Quest Diagnostics,Debit-Card,757,-2772,health,"None,"
03/08/2021,20210308,202103,2021.1,2021,Voya Financial,Debit-Card,-889,-3529,invest,"None,"
03/05/2021,20210305,202103,2021.09,2021,Cognizant Technology Solutions,Debit-Card,356,-2640,tech,"None,"
03/05/2021,20210305,202103,2021.09,2021,United Continental Holdings,Debit-Card,414,-2996,invest,"None,"
03/03/2021,20210303,202103,2021.09,2021,Ulta Beauty,Debit-Card,604,-3410,health,"None,"
03/03/2021,20210303,202103,2021.09,2021,Cognizant Technology Solutions,Debit-Card,0,-4014,tech,"None,"
03/02/2021,20210302,202103,2021.09,2021,Hewlett Packard Enterprise,Debit-Card,-268,-4014,tech,"None,"
03/02/2021,20210302,202103,2021.09,2021,Delta Air Lines,Debit-Card,-661,-3746,travel,"None,"
03/01/2021,20210301,202103,2021.09,2021,Omnicom Group,Debit-Card,-392,-3085,health,"None,"
03/01/2021,20210301,202103,2021.09,2021,Hershey,Debit-Card,142,-2693,grocery,"None,"
03/01/2021,20210301,202103,2021.09,2021,TIAA,Debit-Card,17,-2835,unk,"None,"
03/01/2021,20210301,202103,2021.09,2021,Quest Diagnostics,Debit-Card,559,-2852,health,"None,"
03/01/2021,20210301,202103,2021.09,2021,Hanesbrands,Debit-Card,-203,-3411,unk,"None,"
03/01/2021,20210301,202103,2021.09,2021,Voya Financial,Debit-Card,286,-3208,invest,"None,"
03/01/2021,20210301,202103,2021.09,2021,Hanesbrands,Debit-Card,477,-3494,unk,"None,"
03/01/2021,20210301,202103,2021.09,2021,Quest Diagnostics,Debit-Card,668,-3971,health,"None,"
03/01/2021,20210301,202103,2021.09,2021,Quest Diagnostics,Debit-Card,129,-4639,health,"None,"
03/01/2021,20210301,202103,2021.09,2021,Amazon.com,Debit-Card,-93,-4768,misc,"None,"
02/26/2021,20210226,202102,2021.08,2021,Quest Diagnostics,Debit-Card,-926,-4675,health,"None,"
02/26/2021,20210226,202102,2021.08,2021,Ulta Beauty,Debit-Card,-230,-3749,health,"None,"
02/26/2021,20210226,202102,2021.08,2021,Travelers,Debit-Card,591,-3519,travel,"None,"
02/26/2021,20210226,202102,2021.08,2021,Delta Air Lines,Debit-Card,-805,-4110,travel,"None,"
02/25/2021,20210225,202102,2021.08,2021,Cognizant Technology Solutions,Debit-Card,433,-3305,tech,"None,"
02/24/2021,20210224,202102,2021.08,2021,Walmart,Debit-Card,-217,-3738,grocery,"None,"
02/24/2021,20210224,202102,2021.08,2021,Voya Financial,Debit-Card,775,-3521,invest,"None,"
02/23/2021,20210223,202102,2021.08,2021,PPL,Debit-Card,-774,-4296,paypal,"None,"
02/23/2021,20210223,202102,2021.08,2021,Omnicom Group,Debit-Card,762,-3522,health,"None,"
02/23/2021,20210223,202102,2021.08,2021,Omnicom Group,Debit-Card,-480,-4284,health,"None,"
02/22/2021,20210222,202102,2021.08,2021,Travelers,Debit-Card,385,-3804,travel,"None,"
02/22/2021,20210222,202102,2021.08,2021,Hershey,Debit-Card,111,-4189,grocery,"None,"
02/22/2021,20210222,202102,2021.08,2021,Hershey,Debit-Card,143,-4300,grocery,"None,"
02/22/2021,20210222,202102,2021.08,2021,Hershey,Debit-Card,-180,-4443,grocery,"None,"
02/19/2021,20210219,202102,2021.07,2021,United Continental Holdings,Debit-Card,-121,-4263,invest,"None,"
02/19/2021,20210219,202102,2021.07,2021,Voya Financial,Debit-Card,165,-4142,invest,"None,"
02/19/2021,20210219,202102,2021.07,2021,Omnicom Group,Debit-Card,533,-4307,health,"None,"
02/18/2021,20210218,202102,2021.07,2021,Omnicom Group,Debit-Card,372,-4840,health,"None,"
02/18/2021,20210218,202102,2021.07,2021,Hewlett Packard Enterprise,Debit-Card,479,-5212,tech,"None,"
02/18/2021,20210218,202102,2021.07,2021,Hershey,Debit-Card,814,-5691,grocery,"None,"
02/18/2021,20210218,202102,2021.07,2021,Visa,Debit-Card,-976,-6505,debt,"None,"
02/17/2021,20210217,202102,2021.07,2021,CBRE Group,Debit-Card,-943,-5529,invest,"None,"
02/17/2021,20210217,202102,2021.07,2021,TIAA,Debit-Card,21,-4586,unk,"None,"
02/17/2021,20210217,202102,2021.07,2021,Delta Air Lines,Debit-Card,-578,-4607,travel,"None,"
02/16/2021,20210216,202102,2021.07,2021,Entergy,Debit-Card,-790,-4029,utility,"None,"
02/16/2021,20210216,202102,2021.07,2021,Quest Diagnostics,Debit-Card,-366,-3239,health,"None,"
02/16/2021,20210216,202102,2021.07,2021,Delta Air Lines,Debit-Card,-735,-2873,travel,"None,"
02/16/2021,20210216,202102,2021.07,2021,PPL,Debit-Card,463,-2138,paypal,"None,"
02/16/2021,20210216,202102,2021.07,2021,Hanesbrands,Debit-Card,-762,-2601,unk,"None,"
02/16/2021,20210216,202102,2021.07,2021,Hershey,Debit-Card,-635,-1839,grocery,"None,"
02/16/2021,20210216,202102,2021.07,2021,Quest Diagnostics,Debit-Card,-222,-1204,health,"None,"
02/12/2021,20210212,202102,2021.06,2021,Entergy,Debit-Card,-897,-982,utility,"None,"
02/12/2021,20210212,202102,2021.06,2021,Voya Financial,Debit-Card,-811,-85,invest,"None,"
02/12/2021,20210212,202102,2021.06,2021,Cognizant Technology Solutions,Debit-Card,65,726,tech,"None,"
02/12/2021,20210212,202102,2021.06,2021,Sysco,Debit-Card,361,661,misc,"None,"
02/11/2021,20210211,202102,2021.06,2021,TIAA,Debit-Card,-315,300,unk,"None,"
02/11/2021,20210211,202102,2021.06,2021,Amazon.com,Debit-Card,471,615,misc,"None,"
02/10/2021,20210210,202102,2021.06,2021,United Continental Holdings,Debit-Card,-521,144,invest,"None,"
02/10/2021,20210210,202102,2021.06,2021,Hewlett Packard Enterprise,Debit-Card,-41,665,tech,"None,"
02/10/2021,20210210,202102,2021.06,2021,Hewlett Packard Enterprise,Debit-Card,463,706,tech,"None,"
02/09/2021,20210209,202102,2021.06,2021,Cognizant Technology Solutions,Debit-Card,-981,243,tech,"None,"
02/09/2021,20210209,202102,2021.06,2021,Hewlett Packard Enterprise,Debit-Card,323,1224,tech,"None,"
02/08/2021,20210208,202102,2021.06,2021,Quest Diagnostics,Debit-Card,-498,901,health,"None,"
02/08/2021,20210208,202102,2021.06,2021,Delta Air Lines,Debit-Card,47,1399,travel,"None,"
02/08/2021,20210208,202102,2021.06,2021,Walmart,Debit-Card,-388,1352,grocery,"None,"
02/08/2021,20210208,202102,2021.06,2021,CBRE Group,Debit-Card,-504,1740,invest,"None,"
02/08/2021,20210208,202102,2021.06,2021,Tapestry,Debit-Card,333,2244,clothing,"None,"
02/08/2021,20210208,202102,2021.06,2021,Amazon.com,Debit-Card,-256,1911,misc,"None,"
02/08/2021,20210208,202102,2021.06,2021,Walmart,Debit-Card,-234,2167,grocery,"None,"
02/08/2021,20210208,202102,2021.06,2021,CBRE Group,Debit-Card,13,2401,invest,"None,"
02/05/2021,20210205,202102,2021.05,2021,Tapestry,Debit-Card,13,2388,clothing,"None,"
02/04/2021,20210204,202102,2021.05,2021,Travelers,Debit-Card,-258,2375,travel,"None,"
02/03/2021,20210203,202102,2021.05,2021,Amazon.com,Debit-Card,-915,2633,misc,"None,"
02/03/2021,20210203,202102,2021.05,2021,CBRE Group,Debit-Card,-701,3548,invest,"None,"
02/03/2021,20210203,202102,2021.05,2021,Amazon.com,Debit-Card,668,4249,misc,"None,"
02/02/2021,20210202,202102,2021.05,2021,Quest Diagnostics,Debit-Card,307,3581,health,"None,"
02/02/2021,20210202,202102,2021.05,2021,Voya Financial,Debit-Card,186,3274,invest,"None,"
02/02/2021,20210202,202102,2021.05,2021,Hanesbrands,Debit-Card,700,3088,unk,"None,"
02/01/2021,20210201,202102,2021.05,2021,Entergy,Debit-Card,857,2388,utility,"None,"
02/01/2021,20210201,202102,2021.05,2021,Voya Financial,Debit-Card,104,1531,invest,"None,"
01/29/2021,20210129,202101,2021.04,2021,Walmart,Debit-Card,835,1427,grocery,"None,"
01/29/2021,20210129,202101,2021.04,2021,United Continental Holdings,Debit-Card,-477,592,invest,"None,"
01/28/2021,20210128,202101,2021.04,2021,CBRE Group,Debit-Card,-917,1069,invest,"None,"
01/26/2021,20210126,202101,2021.04,2021,Visa,Debit-Card,-143,1986,debt,"None,"
01/26/2021,20210126,202101,2021.04,2021,TIAA,Debit-Card,369,2129,unk,"None,"
01/25/2021,20210125,202101,2021.04,2021,Sysco,Debit-Card,853,1760,misc,"None,"
01/25/2021,20210125,202101,2021.04,2021,Delta Air Lines,Debit-Card,-801,907,travel,"None,"
01/25/2021,20210125,202101,2021.04,2021,Visa,Debit-Card,81,1708,debt,"None,"
01/22/2021,20210122,202101,2021.03,2021,Voya Financial,Debit-Card,-725,1627,invest,"None,"
01/21/2021,20210121,202101,2021.03,2021,Delta Air Lines,Debit-Card,-774,2352,travel,"None,"
01/21/2021,20210121,202101,2021.03,2021,PPL,Debit-Card,-694,3126,paypal,"None,"
01/20/2021,20210120,202101,2021.03,2021,United Continental Holdings,Debit-Card,821,3820,invest,"None,"
01/20/2021,20210120,202101,2021.03,2021,Amazon.com,Debit-Card,225,2999,misc,"None,"
01/20/2021,20210120,202101,2021.03,2021,Entergy,Debit-Card,-219,2774,utility,"None,"
01/19/2021,20210119,202101,2021.03,2021,Travelers,Debit-Card,179,2993,travel,"None,"
01/19/2021,20210119,202101,2021.03,2021,Voya Financial,Debit-Card,-891,2814,invest,"None,"
01/19/2021,20210119,202101,2021.03,2021,Hershey,Debit-Card,-1000,3705,grocery,"None,"
01/19/2021,20210119,202101,2021.03,2021,United Continental Holdings,Debit-Card,-353,4705,invest,"None,"
01/19/2021,20210119,202101,2021.03,2021,Visa,Debit-Card,132,5058,debt,"None,"
01/19/2021,20210119,202101,2021.03,2021,Hershey,Debit-Card,-838,4926,grocery,"None,"
01/19/2021,20210119,202101,2021.03,2021,PPL,Debit-Card,871,5764,paypal,"None,"
01/19/2021,20210119,202101,2021.03,2021,Hanesbrands,Debit-Card,-21,4893,unk,"None,"
01/19/2021,20210119,202101,2021.03,2021,TIAA,Debit-Card,380,4914,unk,"None,"
01/19/2021,20210119,202101,2021.03,2021,Omnicom Group,Debit-Card,193,4534,health,"None,"
01/15/2021,20210115,202101,2021.02,2021,Tapestry,Debit-Card,431,4341,clothing,"None,"
01/15/2021,20210115,202101,2021.02,2021,United Continental Holdings,Debit-Card,-798,3910,invest,"None,"
01/15/2021,20210115,202101,2021.02,2021,Tapestry,Debit-Card,262,4708,clothing,"None,"
01/14/2021,20210114,202101,2021.02,2021,Sysco,Debit-Card,980,4446,misc,"None,"
01/14/2021,20210114,202101,2021.02,2021,Amazon.com,Debit-Card,-235,3466,misc,"None,"
01/14/2021,20210114,202101,2021.02,2021,Hershey,Debit-Card,293,3701,grocery,"None,"
01/13/2021,20210113,202101,2021.02,2021,Cognizant Technology Solutions,Debit-Card,-865,3408,tech,"None,"
01/12/2021,20210112,202101,2021.02,2021,Visa,Debit-Card,-979,4273,debt,"None,"
01/12/2021,20210112,202101,2021.02,2021,Ulta Beauty,Debit-Card,253,5252,health,"None,"
01/11/2021,20210111,202101,2021.02,2021,Voya Financial,Debit-Card,652,4999,invest,"None,"
01/11/2021,20210111,202101,2021.02,2021,Quest Diagnostics,Debit-Card,-756,4347,health,"None,"
01/11/2021,20210111,202101,2021.02,2021,Voya Financial,Debit-Card,155,5103,invest,"None,"
01/11/2021,20210111,202101,2021.02,2021,Entergy,Debit-Card,568,4948,utility,"None,"
01/11/2021,20210111,202101,2021.02,2021,PPL,Debit-Card,-73,4380,paypal,"None,"
01/11/2021,20210111,202101,2021.02,2021,Tapestry,Debit-Card,290,4453,clothing,"None,"
01/11/2021,20210111,202101,2021.02,2021,Visa,Debit-Card,-389,4163,debt,"None,"
01/08/2021,20210108,202101,2021.01,2021,Cognizant Technology Solutions,Debit-Card,886,4552,tech,"None,"
01/08/2021,20210108,202101,2021.01,2021,Hanesbrands,Debit-Card,464,3666,unk,"None,"
01/07/2021,20210107,202101,2021.01,2021,Visa,Debit-Card,-4,3202,debt,"None,"
01/07/2021,20210107,202101,2021.01,2021,Hanesbrands,Debit-Card,-427,3206,unk,"None,"
01/07/2021,20210107,202101,2021.01,2021,Entergy,Debit-Card,-259,3633,utility,"None,"
01/06/2021,20210106,202101,2021.01,2021,United Continental Holdings,Debit-Card,586,3892,invest,"None,"
01/05/2021,20210105,202101,2021.01,2021,Voya Financial,Debit-Card,630,3306,invest,"None,"
01/05/2021,20210105,202101,2021.01,2021,Omnicom Group,Debit-Card,-82,2676,health,"None,"
01/05/2021,20210105,202101,2021.01,2021,Visa,Debit-Card,-889,2758,debt,"None,"
01/05/2021,20210105,202101,2021.01,2021,PPL,Debit-Card,848,3647,paypal,"None,"
01/04/2021,20210104,202101,2021.01,2021,Walmart,Debit-Card,913,2799,grocery,"None,"
01/04/2021,20210104,202101,2021.01,2021,Hanesbrands,Debit-Card,-331,1886,unk,"None,"
01/04/2021,20210104,202101,2021.01,2021,Amazon.com,Debit-Card,793,2217,misc,"None,"
01/04/2021,20210104,202101,2021.01,2021,Travelers,Debit-Card,-798,1424,travel,"None,"
