Date,YYYYMMDD,YYYYMM,YYYY.W,YYYY,Location,Card,Delta,Balance,Category,Tags
12/31/2020,20201231,202012,2020.52,2020,PPL,Debit-Card,823,2222,health,"None,"
12/31/2020,20201231,202012,2020.52,2020,Travelers,Debit-Card,-708,1399,health,"None,"
12/30/2020,20201230,202012,2020.52,2020,PPL,Debit-Card,410,2107,invest,"None,"
12/29/2020,20201229,202012,2020.52,2020,Travelers,Debit-Card,270,1697,unk,"None,"
12/28/2020,20201228,202012,2020.52,2020,Hanesbrands,Debit-Card,923,1427,tech,"None,"
12/28/2020,20201228,202012,2020.52,2020,Tapestry,Debit-Card,406,504,clothing,"None,"
12/28/2020,20201228,202012,2020.52,2020,CBRE Group,Debit-Card,460,98,invest,"None,"
12/28/2020,20201228,202012,2020.52,2020,CBRE Group,Debit-Card,115,-362,health,"None,"
12/24/2020,20201224,202012,2020.51,2020,Amazon.com,Debit-Card,-61,-477,unk,"None,"
12/22/2020,20201222,202012,2020.51,2020,Tapestry,Debit-Card,-660,-416,misc,"None,"
12/22/2020,20201222,202012,2020.51,2020,TIAA,Debit-Card,-568,244,unk,"None,"
12/22/2020,20201222,202012,2020.51,2020,PPL,Debit-Card,-405,812,clothing,"None,"
12/22/2020,20201222,202012,2020.51,2020,Amazon.com,Debit-Card,-905,1217,travel,"None,"
12/22/2020,20201222,202012,2020.51,2020,Cognizant Technology Solutions,Debit-Card,-534,2122,invest,"None,"
12/21/2020,20201221,202012,2020.51,2020,Hershey,Debit-Card,-705,2656,grocery,"None,"
12/21/2020,20201221,202012,2020.51,2020,United Continental Holdings,Debit-Card,892,3361,grocery,"None,"
12/21/2020,20201221,202012,2020.51,2020,Amazon.com,Debit-Card,36,2469,travel,"None,"
12/21/2020,20201221,202012,2020.51,2020,Delta Air Lines,Debit-Card,-286,2433,debt,"None,"
12/18/2020,20201218,202012,2020.5,2020,Hewlett Packard Enterprise,Debit-Card,786,2719,invest,"None,"
12/18/2020,20201218,202012,2020.5,2020,Walmart,Debit-Card,-584,1933,travel,"None,"
12/18/2020,20201218,202012,2020.5,2020,Hanesbrands,Debit-Card,296,2517,invest,"None,"
12/18/2020,20201218,202012,2020.5,2020,TIAA,Debit-Card,689,2221,paypal,"None,"
12/17/2020,20201217,202012,2020.5,2020,CBRE Group,Debit-Card,-370,1532,health,"None,"
12/17/2020,20201217,202012,2020.5,2020,TIAA,Debit-Card,805,1902,tech,"None,"
12/16/2020,20201216,202012,2020.5,2020,Entergy,Debit-Card,-893,1097,health,"None,"
12/15/2020,20201215,202012,2020.5,2020,Hewlett Packard Enterprise,Debit-Card,310,1990,travel,"None,"
12/15/2020,20201215,202012,2020.5,2020,Tapestry,Debit-Card,205,1680,health,"None,"
12/15/2020,20201215,202012,2020.5,2020,Walmart,Debit-Card,-670,1475,utility,"None,"
12/14/2020,20201214,202012,2020.5,2020,Voya Financial,Debit-Card,-25,2145,travel,"None,"
12/14/2020,20201214,202012,2020.5,2020,Hanesbrands,Debit-Card,-961,2170,unk,"None,"
12/14/2020,20201214,202012,2020.5,2020,TIAA,Debit-Card,-607,3131,unk,"None,"
12/11/2020,20201211,202012,2020.49,2020,Delta Air Lines,Debit-Card,-837,3738,grocery,"None,"
12/11/2020,20201211,202012,2020.49,2020,Travelers,Debit-Card,-593,4575,grocery,"None,"
12/11/2020,20201211,202012,2020.49,2020,Amazon.com,Debit-Card,874,5168,tech,"None,"
12/11/2020,20201211,202012,2020.49,2020,Hershey,Debit-Card,177,4294,misc,"None,"
12/09/2020,20201209,202012,2020.49,2020,Hanesbrands,Debit-Card,256,4117,clothing,"None,"
12/09/2020,20201209,202012,2020.49,2020,Hanesbrands,Debit-Card,51,3861,health,"None,"
12/09/2020,20201209,202012,2020.49,2020,United Continental Holdings,Debit-Card,-951,3810,utility,"None,"
12/08/2020,20201208,202012,2020.49,2020,Sysco,Debit-Card,940,4761,clothing,"None,"
12/08/2020,20201208,202012,2020.49,2020,Amazon.com,Debit-Card,-946,3821,invest,"None,"
12/07/2020,20201207,202012,2020.49,2020,Amazon.com,Debit-Card,577,4767,invest,"None,"
12/07/2020,20201207,202012,2020.49,2020,Ulta Beauty,Debit-Card,-529,4190,tech,"None,"
12/03/2020,20201203,202012,2020.48,2020,Quest Diagnostics,Debit-Card,324,4719,utility,"None,"
12/03/2020,20201203,202012,2020.48,2020,Voya Financial,Debit-Card,-442,4395,unk,"None,"
12/03/2020,20201203,202012,2020.48,2020,Omnicom Group,Debit-Card,494,4837,invest,"None,"
12/02/2020,20201202,202012,2020.48,2020,Ulta Beauty,Debit-Card,619,4343,unk,"None,"
12/02/2020,20201202,202012,2020.48,2020,Sysco,Debit-Card,-125,3724,health,"None,"
12/01/2020,20201201,202012,2020.48,2020,Sysco,Debit-Card,651,3849,health,"None,"
12/01/2020,20201201,202012,2020.48,2020,TIAA,Debit-Card,-147,3198,invest,"None,"
12/01/2020,20201201,202012,2020.48,2020,Hershey,Debit-Card,269,3345,unk,"None,"
11/30/2020,20201130,202011,2020.48,2020,CBRE Group,Debit-Card,-287,3076,unk,"None,"
11/30/2020,20201130,202011,2020.48,2020,Voya Financial,Debit-Card,147,3363,invest,"None,"
11/27/2020,20201127,202011,2020.47,2020,Sysco,Debit-Card,521,3216,paypal,"None,"
11/23/2020,20201123,202011,2020.47,2020,Omnicom Group,Debit-Card,17,2695,travel,"None,"
11/23/2020,20201123,202011,2020.47,2020,Voya Financial,Debit-Card,-253,2678,tech,"None,"
11/23/2020,20201123,202011,2020.47,2020,Sysco,Debit-Card,836,2931,tech,"None,"
11/23/2020,20201123,202011,2020.47,2020,Delta Air Lines,Debit-Card,505,2095,invest,"None,"
11/23/2020,20201123,202011,2020.47,2020,Amazon.com,Debit-Card,-707,1590,clothing,"None,"
11/23/2020,20201123,202011,2020.47,2020,Hewlett Packard Enterprise,Debit-Card,-917,2297,tech,"None,"
11/23/2020,20201123,202011,2020.47,2020,Voya Financial,Debit-Card,-748,3214,grocery,"None,"
11/20/2020,20201120,202011,2020.46,2020,Voya Financial,Debit-Card,-467,3962,health,"None,"
11/20/2020,20201120,202011,2020.46,2020,Hershey,Debit-Card,-217,4429,unk,"None,"
11/18/2020,20201118,202011,2020.46,2020,Omnicom Group,Debit-Card,-535,4646,paypal,"None,"
11/17/2020,20201117,202011,2020.46,2020,PPL,Debit-Card,-890,5181,grocery,"None,"
11/17/2020,20201117,202011,2020.46,2020,Visa,Debit-Card,770,6071,paypal,"None,"
11/17/2020,20201117,202011,2020.46,2020,Voya Financial,Debit-Card,811,5301,unk,"None,"
11/16/2020,20201116,202011,2020.46,2020,Hershey,Debit-Card,-66,4490,health,"None,"
11/16/2020,20201116,202011,2020.46,2020,Walmart,Debit-Card,761,4556,misc,"None,"
11/16/2020,20201116,202011,2020.46,2020,Quest Diagnostics,Debit-Card,880,3795,travel,"None,"
11/16/2020,20201116,202011,2020.46,2020,Hanesbrands,Debit-Card,280,2915,tech,"None,"
11/16/2020,20201116,202011,2020.46,2020,Entergy,Debit-Card,318,2635,invest,"None,"
11/16/2020,20201116,202011,2020.46,2020,Entergy,Debit-Card,574,2317,unk,"None,"
11/13/2020,20201113,202011,2020.45,2020,Sysco,Debit-Card,-660,1743,invest,"None,"
11/13/2020,20201113,202011,2020.45,2020,United Continental Holdings,Debit-Card,-402,2403,invest,"None,"
11/13/2020,20201113,202011,2020.45,2020,Omnicom Group,Debit-Card,-720,2805,grocery,"None,"
11/12/2020,20201112,202011,2020.45,2020,United Continental Holdings,Debit-Card,557,3525,utility,"None,"
11/12/2020,20201112,202011,2020.45,2020,Sysco,Debit-Card,93,2968,travel,"None,"
11/12/2020,20201112,202011,2020.45,2020,Ulta Beauty,Debit-Card,-604,2875,invest,"None,"
11/12/2020,20201112,202011,2020.45,2020,Visa,Debit-Card,-347,3479,paypal,"None,"
11/10/2020,20201110,202011,2020.45,2020,Walmart,Debit-Card,207,3826,grocery,"None,"
11/09/2020,20201109,202011,2020.45,2020,Cognizant Technology Solutions,Debit-Card,964,3619,debt,"None,"
11/09/2020,20201109,202011,2020.45,2020,Hershey,Debit-Card,416,2655,grocery,"None,"
11/09/2020,20201109,202011,2020.45,2020,Walmart,Debit-Card,217,2239,paypal,"None,"
11/09/2020,20201109,202011,2020.45,2020,Sysco,Debit-Card,785,2022,misc,"None,"
11/06/2020,20201106,202011,2020.44,2020,Delta Air Lines,Debit-Card,981,1237,health,"None,"
11/04/2020,20201104,202011,2020.44,2020,TIAA,Debit-Card,463,256,utility,"None,"
11/02/2020,20201102,202011,2020.44,2020,Amazon.com,Debit-Card,-150,-207,clothing,"None,"
11/02/2020,20201102,202011,2020.44,2020,Cognizant Technology Solutions,Debit-Card,605,-57,paypal,"None,"
11/02/2020,20201102,202011,2020.44,2020,Ulta Beauty,Debit-Card,-520,-662,invest,"None,"
11/02/2020,20201102,202011,2020.44,2020,Hanesbrands,Debit-Card,202,-142,invest,"None,"
11/02/2020,20201102,202011,2020.44,2020,Cognizant Technology Solutions,Debit-Card,312,-344,paypal,"None,"
10/30/2020,20201030,202010,2020.43,2020,Amazon.com,Debit-Card,838,-656,invest,"None,"
10/30/2020,20201030,202010,2020.43,2020,Voya Financial,Debit-Card,492,-1494,tech,"None,"
10/30/2020,20201030,202010,2020.43,2020,Voya Financial,Debit-Card,-357,-1986,travel,"None,"
10/30/2020,20201030,202010,2020.43,2020,Hewlett Packard Enterprise,Debit-Card,-17,-1629,grocery,"None,"
10/30/2020,20201030,202010,2020.43,2020,Ulta Beauty,Debit-Card,-553,-1612,clothing,"None,"
10/28/2020,20201028,202010,2020.43,2020,Hershey,Debit-Card,-476,-1059,travel,"None,"
10/28/2020,20201028,202010,2020.43,2020,CBRE Group,Debit-Card,-72,-583,invest,"None,"
10/26/2020,20201026,202010,2020.43,2020,Amazon.com,Debit-Card,-914,-511,debt,"None,"
10/26/2020,20201026,202010,2020.43,2020,Visa,Debit-Card,-948,403,paypal,"None,"
10/23/2020,20201023,202010,2020.42,2020,Amazon.com,Debit-Card,-340,1351,clothing,"None,"
10/23/2020,20201023,202010,2020.42,2020,Voya Financial,Debit-Card,999,1691,unk,"None,"
10/23/2020,20201023,202010,2020.42,2020,Hanesbrands,Debit-Card,501,692,travel,"None,"
10/22/2020,20201022,202010,2020.42,2020,Travelers,Debit-Card,847,191,unk,"None,"
10/21/2020,20201021,202010,2020.42,2020,TIAA,Debit-Card,-751,-656,travel,"None,"
10/21/2020,20201021,202010,2020.42,2020,TIAA,Debit-Card,258,95,invest,"None,"
10/20/2020,20201020,202010,2020.42,2020,PPL,Debit-Card,546,-163,health,"None,"
10/20/2020,20201020,202010,2020.42,2020,CBRE Group,Debit-Card,-126,-709,unk,"None,"
10/19/2020,20201019,202010,2020.42,2020,Hanesbrands,Debit-Card,886,-583,debt,"None,"
10/19/2020,20201019,202010,2020.42,2020,United Continental Holdings,Debit-Card,-281,-1469,health,"None,"
10/19/2020,20201019,202010,2020.42,2020,Cognizant Technology Solutions,Debit-Card,-951,-1188,tech,"None,"
10/19/2020,20201019,202010,2020.42,2020,Cognizant Technology Solutions,Debit-Card,-255,-237,unk,"None,"
10/19/2020,20201019,202010,2020.42,2020,PPL,Debit-Card,257,18,paypal,"None,"
10/19/2020,20201019,202010,2020.42,2020,TIAA,Debit-Card,528,-239,health,"None,"
10/19/2020,20201019,202010,2020.42,2020,Quest Diagnostics,Debit-Card,870,-767,unk,"None,"
10/19/2020,20201019,202010,2020.42,2020,Tapestry,Debit-Card,956,-1637,grocery,"None,"
10/16/2020,20201016,202010,2020.41,2020,Hanesbrands,Debit-Card,492,-2593,grocery,"None,"
10/16/2020,20201016,202010,2020.41,2020,Travelers,Debit-Card,-745,-3085,misc,"None,"
10/15/2020,20201015,202010,2020.41,2020,Voya Financial,Debit-Card,461,-2340,utility,"None,"
10/14/2020,20201014,202010,2020.41,2020,Delta Air Lines,Debit-Card,393,-2801,invest,"None,"
10/14/2020,20201014,202010,2020.41,2020,Omnicom Group,Debit-Card,669,-3194,tech,"None,"
10/14/2020,20201014,202010,2020.41,2020,United Continental Holdings,Debit-Card,757,-3863,invest,"None,"
10/13/2020,20201013,202010,2020.41,2020,TIAA,Debit-Card,-128,-4620,invest,"None,"
10/13/2020,20201013,202010,2020.41,2020,Omnicom Group,Debit-Card,-603,-4492,grocery,"None,"
10/13/2020,20201013,202010,2020.41,2020,United Continental Holdings,Debit-Card,-408,-3889,grocery,"None,"
10/13/2020,20201013,202010,2020.41,2020,Hanesbrands,Debit-Card,-904,-3481,travel,"None,"
10/13/2020,20201013,202010,2020.41,2020,United Continental Holdings,Debit-Card,-841,-2577,tech,"None,"
10/13/2020,20201013,202010,2020.41,2020,Omnicom Group,Debit-Card,303,-1736,unk,"None,"
10/13/2020,20201013,202010,2020.41,2020,Hershey,Debit-Card,715,-2039,health,"None,"
10/09/2020,20201009,202010,2020.4,2020,Cognizant Technology Solutions,Debit-Card,482,-2754,invest,"None,"
10/09/2020,20201009,202010,2020.4,2020,Tapestry,Debit-Card,-742,-3236,invest,"None,"
10/08/2020,20201008,202010,2020.4,2020,Entergy,Debit-Card,255,-2494,grocery,"None,"
10/08/2020,20201008,202010,2020.4,2020,Walmart,Debit-Card,45,-2749,invest,"None,"
10/08/2020,20201008,202010,2020.4,2020,Hershey,Debit-Card,-901,-2794,grocery,"None,"
10/07/2020,20201007,202010,2020.4,2020,Travelers,Debit-Card,441,-1893,paypal,"None,"
10/06/2020,20201006,202010,2020.4,2020,Hershey,Debit-Card,42,-2334,invest,"None,"
10/06/2020,20201006,202010,2020.4,2020,Tapestry,Debit-Card,321,-2376,debt,"None,"
10/06/2020,20201006,202010,2020.4,2020,PPL,Debit-Card,-793,-2697,health,"None,"
10/05/2020,20201005,202010,2020.4,2020,Travelers,Debit-Card,314,-1904,invest,"None,"
10/05/2020,20201005,202010,2020.4,2020,Voya Financial,Debit-Card,482,-2218,travel,"None,"
10/05/2020,20201005,202010,2020.4,2020,Amazon.com,Debit-Card,820,-2700,unk,"None,"
10/05/2020,20201005,202010,2020.4,2020,Cognizant Technology Solutions,Debit-Card,-548,-3520,unk,"None,"
10/05/2020,20201005,202010,2020.4,2020,United Continental Holdings,Debit-Card,-17,-2972,tech,"None,"
10/05/2020,20201005,202010,2020.4,2020,Hershey,Debit-Card,-737,-2955,utility,"None,"
10/02/2020,20201002,202010,2020.39,2020,Amazon.com,Debit-Card,15,-2218,utility,"None,"
10/02/2020,20201002,202010,2020.39,2020,PPL,Debit-Card,450,-2233,health,"None,"
10/02/2020,20201002,202010,2020.39,2020,Voya Financial,Debit-Card,-360,-2683,grocery,"None,"
10/01/2020,20201001,202010,2020.39,2020,CBRE Group,Debit-Card,445,-2323,grocery,"None,"
10/01/2020,20201001,202010,2020.39,2020,PPL,Debit-Card,167,-2768,clothing,"None,"
10/01/2020,20201001,202010,2020.39,2020,Walmart,Debit-Card,227,-2935,misc,"None,"
10/01/2020,20201001,202010,2020.39,2020,Delta Air Lines,Debit-Card,-291,-3162,misc,"None,"
09/30/2020,20200930,202009,2020.39,2020,United Continental Holdings,Debit-Card,604,-2871,unk,"None,"
09/30/2020,20200930,202009,2020.39,2020,Entergy,Debit-Card,-448,-3475,unk,"None,"
09/29/2020,20200929,202009,2020.39,2020,PPL,Debit-Card,782,-3027,misc,"None,"
09/28/2020,20200928,202009,2020.39,2020,Amazon.com,Debit-Card,-231,-3809,debt,"None,"
09/25/2020,20200925,202009,2020.38,2020,Visa,Debit-Card,-546,-3578,travel,"None,"
09/25/2020,20200925,202009,2020.38,2020,Hewlett Packard Enterprise,Debit-Card,-454,-3032,misc,"None,"
09/23/2020,20200923,202009,2020.38,2020,Delta Air Lines,Debit-Card,343,-2578,tech,"None,"
09/23/2020,20200923,202009,2020.38,2020,Hershey,Debit-Card,-388,-2921,travel,"None,"
09/22/2020,20200922,202009,2020.38,2020,TIAA,Debit-Card,-937,-2533,unk,"None,"
09/22/2020,20200922,202009,2020.38,2020,Hershey,Debit-Card,296,-1596,tech,"None,"
09/21/2020,20200921,202009,2020.38,2020,Visa,Debit-Card,-72,-1892,invest,"None,"
09/21/2020,20200921,202009,2020.38,2020,Cognizant Technology Solutions,Debit-Card,285,-1820,unk,"None,"
09/21/2020,20200921,202009,2020.38,2020,Hanesbrands,Debit-Card,692,-2105,misc,"None,"
09/21/2020,20200921,202009,2020.38,2020,CBRE Group,Debit-Card,619,-2797,clothing,"None,"
09/21/2020,20200921,202009,2020.38,2020,Ulta Beauty,Debit-Card,-112,-3416,travel,"None,"
09/21/2020,20200921,202009,2020.38,2020,Hershey,Debit-Card,-879,-3304,invest,"None,"
09/18/2020,20200918,202009,2020.37,2020,Tapestry,Debit-Card,-404,-2425,invest,"None,"
09/18/2020,20200918,202009,2020.37,2020,Tapestry,Debit-Card,-609,-2021,tech,"None,"
09/17/2020,20200917,202009,2020.37,2020,Hanesbrands,Debit-Card,-918,-1412,unk,"None,"
09/15/2020,20200915,202009,2020.37,2020,Sysco,Debit-Card,992,-494,utility,"None,"
09/15/2020,20200915,202009,2020.37,2020,Visa,Debit-Card,891,-1486,health,"None,"
09/14/2020,20200914,202009,2020.37,2020,Quest Diagnostics,Debit-Card,903,-2377,misc,"None,"
09/14/2020,20200914,202009,2020.37,2020,Quest Diagnostics,Debit-Card,362,-3280,invest,"None,"
09/14/2020,20200914,202009,2020.37,2020,Tapestry,Debit-Card,74,-3642,health,"None,"
09/14/2020,20200914,202009,2020.37,2020,Omnicom Group,Debit-Card,-636,-3716,invest,"None,"
09/11/2020,20200911,202009,2020.36,2020,Walmart,Debit-Card,-974,-3080,grocery,"None,"
09/10/2020,20200910,202009,2020.36,2020,Walmart,Debit-Card,-25,-2106,travel,"None,"
09/09/2020,20200909,202009,2020.36,2020,United Continental Holdings,Debit-Card,-843,-2081,unk,"None,"
09/09/2020,20200909,202009,2020.36,2020,Ulta Beauty,Debit-Card,-973,-1238,grocery,"None,"
09/09/2020,20200909,202009,2020.36,2020,Tapestry,Debit-Card,-142,-265,paypal,"None,"
09/08/2020,20200908,202009,2020.36,2020,United Continental Holdings,Debit-Card,168,-123,clothing,"None,"
09/08/2020,20200908,202009,2020.36,2020,Omnicom Group,Debit-Card,-27,-291,unk,"None,"
09/08/2020,20200908,202009,2020.36,2020,CBRE Group,Debit-Card,-695,-264,debt,"None,"
09/08/2020,20200908,202009,2020.36,2020,Hanesbrands,Debit-Card,285,431,misc,"None,"
09/08/2020,20200908,202009,2020.36,2020,Walmart,Debit-Card,53,146,misc,"None,"
09/08/2020,20200908,202009,2020.36,2020,Cognizant Technology Solutions,Debit-Card,676,93,tech,"None,"
09/08/2020,20200908,202009,2020.36,2020,Sysco,Debit-Card,-545,-583,misc,"None,"
09/04/2020,20200904,202009,2020.35,2020,Ulta Beauty,Debit-Card,398,-38,travel,"None,"
09/04/2020,20200904,202009,2020.35,2020,Omnicom Group,Debit-Card,-135,-436,invest,"None,"
09/04/2020,20200904,202009,2020.35,2020,Hewlett Packard Enterprise,Debit-Card,-579,-301,unk,"None,"
09/04/2020,20200904,202009,2020.35,2020,Visa,Debit-Card,625,278,tech,"None,"
09/04/2020,20200904,202009,2020.35,2020,Hanesbrands,Debit-Card,-143,-347,travel,"None,"
09/02/2020,20200902,202009,2020.35,2020,Travelers,Debit-Card,153,-204,paypal,"None,"
09/02/2020,20200902,202009,2020.35,2020,Walmart,Debit-Card,-27,-357,travel,"None,"
09/01/2020,20200901,202009,2020.35,2020,Voya Financial,Debit-Card,196,-330,misc,"None,"
08/31/2020,20200831,202008,2020.35,2020,Walmart,Debit-Card,-109,-526,utility,"None,"
08/31/2020,20200831,202008,2020.35,2020,Quest Diagnostics,Debit-Card,235,-417,utility,"None,"
08/31/2020,20200831,202008,2020.35,2020,Hewlett Packard Enterprise,Debit-Card,-550,-652,travel,"None,"
08/28/2020,20200828,202008,2020.34,2020,Sysco,Debit-Card,-398,-102,grocery,"None,"
08/25/2020,20200825,202008,2020.34,2020,United Continental Holdings,Debit-Card,-270,296,clothing,"None,"
08/25/2020,20200825,202008,2020.34,2020,Cognizant Technology Solutions,Debit-Card,978,566,unk,"None,"
08/25/2020,20200825,202008,2020.34,2020,Hewlett Packard Enterprise,Debit-Card,-42,-412,clothing,"None,"
08/24/2020,20200824,202008,2020.34,2020,Quest Diagnostics,Debit-Card,955,-370,debt,"None,"
08/24/2020,20200824,202008,2020.34,2020,United Continental Holdings,Debit-Card,-269,-1325,misc,"None,"
08/24/2020,20200824,202008,2020.34,2020,Hershey,Debit-Card,-161,-1056,grocery,"None,"
08/24/2020,20200824,202008,2020.34,2020,PPL,Debit-Card,469,-895,misc,"None,"
08/21/2020,20200821,202008,2020.33,2020,Sysco,Debit-Card,244,-1364,invest,"None,"
08/21/2020,20200821,202008,2020.33,2020,Delta Air Lines,Debit-Card,973,-1608,invest,"None,"
08/20/2020,20200820,202008,2020.33,2020,Amazon.com,Debit-Card,-683,-2581,health,"None,"
08/20/2020,20200820,202008,2020.33,2020,Entergy,Debit-Card,90,-1898,health,"None,"
08/19/2020,20200819,202008,2020.33,2020,Hanesbrands,Debit-Card,-66,-1988,health,"None,"
08/18/2020,20200818,202008,2020.33,2020,Hewlett Packard Enterprise,Debit-Card,267,-1922,unk,"None,"
08/18/2020,20200818,202008,2020.33,2020,Hewlett Packard Enterprise,Debit-Card,274,-2189,clothing,"None,"
08/18/2020,20200818,202008,2020.33,2020,United Continental Holdings,Debit-Card,-449,-2463,grocery,"None,"
08/17/2020,20200817,202008,2020.33,2020,PPL,Debit-Card,-139,-2014,tech,"None,"
08/17/2020,20200817,202008,2020.33,2020,TIAA,Debit-Card,-618,-1875,utility,"None,"
08/17/2020,20200817,202008,2020.33,2020,Walmart,Debit-Card,397,-1257,invest,"None,"
08/17/2020,20200817,202008,2020.33,2020,Walmart,Debit-Card,-611,-1654,grocery,"None,"
08/17/2020,20200817,202008,2020.33,2020,Hanesbrands,Debit-Card,680,-1043,travel,"None,"
08/17/2020,20200817,202008,2020.33,2020,Voya Financial,Debit-Card,-991,-1723,invest,"None,"
08/17/2020,20200817,202008,2020.33,2020,Sysco,Debit-Card,428,-732,misc,"None,"
08/14/2020,20200814,202008,2020.32,2020,Visa,Debit-Card,642,-1160,misc,"None,"
08/14/2020,20200814,202008,2020.32,2020,Sysco,Debit-Card,688,-1802,invest,"None,"
08/13/2020,20200813,202008,2020.32,2020,Omnicom Group,Debit-Card,-342,-2490,paypal,"None,"
08/13/2020,20200813,202008,2020.32,2020,PPL,Debit-Card,930,-2148,grocery,"None,"
08/12/2020,20200812,202008,2020.32,2020,CBRE Group,Debit-Card,-849,-3078,health,"None,"
08/11/2020,20200811,202008,2020.32,2020,Tapestry,Debit-Card,567,-2229,debt,"None,"
08/11/2020,20200811,202008,2020.32,2020,Omnicom Group,Debit-Card,544,-2796,misc,"None,"
08/11/2020,20200811,202008,2020.32,2020,Ulta Beauty,Debit-Card,-954,-3340,paypal,"None,"
08/11/2020,20200811,202008,2020.32,2020,Hewlett Packard Enterprise,Debit-Card,-744,-2386,health,"None,"
08/10/2020,20200810,202008,2020.32,2020,Amazon.com,Debit-Card,-735,-1642,health,"None,"
08/10/2020,20200810,202008,2020.32,2020,Hewlett Packard Enterprise,Debit-Card,-410,-907,health,"None,"
08/10/2020,20200810,202008,2020.32,2020,Ulta Beauty,Debit-Card,463,-497,utility,"None,"
08/07/2020,20200807,202008,2020.31,2020,Voya Financial,Debit-Card,-88,-960,misc,"None,"
08/07/2020,20200807,202008,2020.31,2020,TIAA,Debit-Card,586,-872,grocery,"None,"
08/07/2020,20200807,202008,2020.31,2020,Travelers,Debit-Card,-837,-1458,clothing,"None,"
08/07/2020,20200807,202008,2020.31,2020,Ulta Beauty,Debit-Card,-909,-621,utility,"None,"
08/07/2020,20200807,202008,2020.31,2020,Ulta Beauty,Debit-Card,-491,288,unk,"None,"
08/05/2020,20200805,202008,2020.31,2020,Ulta Beauty,Debit-Card,298,779,unk,"None,"
08/04/2020,20200804,202008,2020.31,2020,Sysco,Debit-Card,491,481,paypal,"None,"
08/04/2020,20200804,202008,2020.31,2020,United Continental Holdings,Debit-Card,269,-10,misc,"None,"
08/04/2020,20200804,202008,2020.31,2020,Entergy,Debit-Card,932,-279,health,"None,"
08/04/2020,20200804,202008,2020.31,2020,Hershey,Debit-Card,-837,-1211,health,"None,"
08/03/2020,20200803,202008,2020.31,2020,Tapestry,Debit-Card,-84,-374,tech,"None,"
08/03/2020,20200803,202008,2020.31,2020,Hershey,Debit-Card,-440,-290,clothing,"None,"
08/03/2020,20200803,202008,2020.31,2020,Hanesbrands,Debit-Card,-428,150,clothing,"None,"
08/03/2020,20200803,202008,2020.31,2020,Cognizant Technology Solutions,Debit-Card,578,578,tech,"None,"
08/03/2020,20200803,202008,2020.31,2020,Travelers,Debit-Card,633,0,debt,"None,"
07/31/2020,20200731,202007,2020.3,2020,Hewlett Packard Enterprise,Debit-Card,-848,-633,invest,"None,"
07/31/2020,20200731,202007,2020.3,2020,Delta Air Lines,Debit-Card,-426,215,invest,"None,"
07/31/2020,20200731,202007,2020.3,2020,Cognizant Technology Solutions,Debit-Card,633,641,clothing,"None,"
07/30/2020,20200730,202007,2020.3,2020,United Continental Holdings,Debit-Card,262,8,grocery,"None,"
07/30/2020,20200730,202007,2020.3,2020,Hewlett Packard Enterprise,Debit-Card,-61,-254,misc,"None,"
07/30/2020,20200730,202007,2020.3,2020,TIAA,Debit-Card,292,-193,unk,"None,"
07/29/2020,20200729,202007,2020.3,2020,Delta Air Lines,Debit-Card,603,-485,misc,"None,"
07/28/2020,20200728,202007,2020.3,2020,Voya Financial,Debit-Card,353,-1088,travel,"None,"
07/28/2020,20200728,202007,2020.3,2020,Walmart,Debit-Card,96,-1441,travel,"None,"
07/28/2020,20200728,202007,2020.3,2020,Delta Air Lines,Debit-Card,542,-1537,travel,"None,"
07/27/2020,20200727,202007,2020.3,2020,Entergy,Debit-Card,707,-2079,health,"None,"
07/27/2020,20200727,202007,2020.3,2020,Hewlett Packard Enterprise,Debit-Card,-99,-2786,utility,"None,"
07/22/2020,20200722,202007,2020.29,2020,Delta Air Lines,Debit-Card,-863,-2687,travel,"None,"
07/22/2020,20200722,202007,2020.29,2020,Hewlett Packard Enterprise,Debit-Card,793,-1824,grocery,"None,"
07/22/2020,20200722,202007,2020.29,2020,PPL,Debit-Card,947,-2617,tech,"None,"
07/22/2020,20200722,202007,2020.29,2020,Travelers,Debit-Card,-230,-3564,misc,"None,"
07/22/2020,20200722,202007,2020.29,2020,Entergy,Debit-Card,591,-3334,unk,"None,"
07/20/2020,20200720,202007,2020.29,2020,Delta Air Lines,Debit-Card,-413,-3925,travel,"None,"
07/20/2020,20200720,202007,2020.29,2020,Amazon.com,Debit-Card,-472,-3512,travel,"None,"
07/20/2020,20200720,202007,2020.29,2020,Voya Financial,Debit-Card,-665,-3040,tech,"None,"
07/20/2020,20200720,202007,2020.29,2020,Hewlett Packard Enterprise,Debit-Card,-780,-2375,travel,"None,"
07/20/2020,20200720,202007,2020.29,2020,Ulta Beauty,Debit-Card,-748,-1595,travel,"None,"
07/16/2020,20200716,202007,2020.28,2020,Entergy,Debit-Card,-281,-847,invest,"None,"
07/15/2020,20200715,202007,2020.28,2020,Travelers,Debit-Card,-230,-566,travel,"None,"
07/14/2020,20200714,202007,2020.28,2020,Amazon.com,Debit-Card,669,-336,tech,"None,"
07/14/2020,20200714,202007,2020.28,2020,Omnicom Group,Debit-Card,-310,-1005,invest,"None,"
07/13/2020,20200713,202007,2020.28,2020,Hewlett Packard Enterprise,Debit-Card,-807,-695,unk,"None,"
07/13/2020,20200713,202007,2020.28,2020,Voya Financial,Debit-Card,357,112,travel,"None,"
07/13/2020,20200713,202007,2020.28,2020,Walmart,Debit-Card,374,-245,health,"None,"
07/13/2020,20200713,202007,2020.28,2020,Tapestry,Debit-Card,752,-619,invest,"None,"
07/13/2020,20200713,202007,2020.28,2020,Ulta Beauty,Debit-Card,743,-1371,health,"None,"
07/10/2020,20200710,202007,2020.27,2020,Voya Financial,Debit-Card,-50,-2114,utility,"None,"
07/10/2020,20200710,202007,2020.27,2020,Amazon.com,Debit-Card,-854,-2064,paypal,"None,"
07/08/2020,20200708,202007,2020.27,2020,PPL,Debit-Card,284,-1210,unk,"None,"
07/08/2020,20200708,202007,2020.27,2020,Delta Air Lines,Debit-Card,-950,-1494,grocery,"None,"
07/08/2020,20200708,202007,2020.27,2020,TIAA,Debit-Card,-273,-544,health,"None,"
07/08/2020,20200708,202007,2020.27,2020,CBRE Group,Debit-Card,190,-271,unk,"None,"
07/08/2020,20200708,202007,2020.27,2020,Visa,Debit-Card,-703,-461,invest,"None,"
07/07/2020,20200707,202007,2020.27,2020,Omnicom Group,Debit-Card,191,242,grocery,"None,"
07/07/2020,20200707,202007,2020.27,2020,Sysco,Debit-Card,-579,51,tech,"None,"
07/06/2020,20200706,202007,2020.27,2020,PPL,Debit-Card,-223,630,tech,"None,"
07/06/2020,20200706,202007,2020.27,2020,Delta Air Lines,Debit-Card,-982,853,health,"None,"
07/06/2020,20200706,202007,2020.27,2020,Ulta Beauty,Debit-Card,-855,1835,health,"None,"
07/06/2020,20200706,202007,2020.27,2020,Omnicom Group,Debit-Card,865,2690,invest,"None,"
07/06/2020,20200706,202007,2020.27,2020,Hanesbrands,Debit-Card,655,1825,invest,"None,"
07/03/2020,20200703,202007,2020.26,2020,Delta Air Lines,Debit-Card,-624,1170,debt,"None,"
07/03/2020,20200703,202007,2020.26,2020,Ulta Beauty,Debit-Card,-95,1794,paypal,"None,"
07/03/2020,20200703,202007,2020.26,2020,Cognizant Technology Solutions,Debit-Card,-901,1889,unk,"None,"
07/02/2020,20200702,202007,2020.26,2020,Tapestry,Debit-Card,-832,2790,debt,"None,"
07/02/2020,20200702,202007,2020.26,2020,Hanesbrands,Debit-Card,-434,3622,tech,"None,"
07/02/2020,20200702,202007,2020.26,2020,Omnicom Group,Debit-Card,-633,4056,grocery,"None,"
06/30/2020,20200630,202006,2020.26,2020,Travelers,Debit-Card,461,4689,grocery,"None,"
06/30/2020,20200630,202006,2020.26,2020,Delta Air Lines,Debit-Card,-96,4228,invest,"None,"
06/30/2020,20200630,202006,2020.26,2020,Ulta Beauty,Debit-Card,353,4324,travel,"None,"
06/29/2020,20200629,202006,2020.26,2020,Voya Financial,Debit-Card,114,3971,invest,"None,"
06/29/2020,20200629,202006,2020.26,2020,TIAA,Debit-Card,-765,3857,travel,"None,"
06/29/2020,20200629,202006,2020.26,2020,Visa,Debit-Card,80,4622,invest,"None,"
06/29/2020,20200629,202006,2020.26,2020,United Continental Holdings,Debit-Card,-577,4542,misc,"None,"
06/25/2020,20200625,202006,2020.25,2020,Delta Air Lines,Debit-Card,836,5119,debt,"None,"
06/25/2020,20200625,202006,2020.25,2020,Sysco,Debit-Card,-637,4283,tech,"None,"
06/24/2020,20200624,202006,2020.25,2020,Travelers,Debit-Card,358,4920,travel,"None,"
06/22/2020,20200622,202006,2020.25,2020,Delta Air Lines,Debit-Card,941,4562,unk,"None,"
06/22/2020,20200622,202006,2020.25,2020,PPL,Debit-Card,859,3621,debt,"None,"
06/22/2020,20200622,202006,2020.25,2020,Hewlett Packard Enterprise,Debit-Card,-992,2762,health,"None,"
06/22/2020,20200622,202006,2020.25,2020,Amazon.com,Debit-Card,-641,3754,travel,"None,"
06/22/2020,20200622,202006,2020.25,2020,Walmart,Debit-Card,-408,4395,unk,"None,"
06/22/2020,20200622,202006,2020.25,2020,Sysco,Debit-Card,679,4803,invest,"None,"
06/19/2020,20200619,202006,2020.24,2020,Voya Financial,Debit-Card,-262,4124,invest,"None,"
06/18/2020,20200618,202006,2020.24,2020,Amazon.com,Debit-Card,-160,4386,debt,"None,"
06/17/2020,20200617,202006,2020.24,2020,Quest Diagnostics,Debit-Card,-916,4546,invest,"None,"
06/17/2020,20200617,202006,2020.24,2020,Walmart,Debit-Card,845,5462,tech,"None,"
06/17/2020,20200617,202006,2020.24,2020,CBRE Group,Debit-Card,-990,4617,unk,"None,"
06/16/2020,20200616,202006,2020.24,2020,Cognizant Technology Solutions,Debit-Card,-441,5607,tech,"None,"
06/16/2020,20200616,202006,2020.24,2020,Tapestry,Debit-Card,-859,6048,tech,"None,"
06/16/2020,20200616,202006,2020.24,2020,Ulta Beauty,Debit-Card,-723,6907,unk,"None,"
06/16/2020,20200616,202006,2020.24,2020,Visa,Debit-Card,-272,7630,grocery,"None,"
06/15/2020,20200615,202006,2020.24,2020,TIAA,Debit-Card,-76,7902,misc,"None,"
06/15/2020,20200615,202006,2020.24,2020,Ulta Beauty,Debit-Card,775,7978,utility,"None,"
06/15/2020,20200615,202006,2020.24,2020,Cognizant Technology Solutions,Debit-Card,-292,7203,unk,"None,"
06/12/2020,20200612,202006,2020.23,2020,Hewlett Packard Enterprise,Debit-Card,238,7495,misc,"None,"
06/12/2020,20200612,202006,2020.23,2020,Entergy,Debit-Card,762,7257,debt,"None,"
06/12/2020,20200612,202006,2020.23,2020,Tapestry,Debit-Card,507,6495,unk,"None,"
06/12/2020,20200612,202006,2020.23,2020,Travelers,Debit-Card,-861,5988,travel,"None,"
06/11/2020,20200611,202006,2020.23,2020,Voya Financial,Debit-Card,446,6849,misc,"None,"
06/11/2020,20200611,202006,2020.23,2020,Entergy,Debit-Card,-66,6403,misc,"None,"
06/10/2020,20200610,202006,2020.23,2020,Voya Financial,Debit-Card,893,6469,tech,"None,"
06/10/2020,20200610,202006,2020.23,2020,Amazon.com,Debit-Card,505,5576,travel,"None,"
06/09/2020,20200609,202006,2020.23,2020,TIAA,Debit-Card,998,5071,invest,"None,"
06/08/2020,20200608,202006,2020.23,2020,Amazon.com,Debit-Card,783,4073,health,"None,"
06/08/2020,20200608,202006,2020.23,2020,Visa,Debit-Card,-340,3290,invest,"None,"
06/08/2020,20200608,202006,2020.23,2020,Hewlett Packard Enterprise,Debit-Card,-193,3630,misc,"None,"
06/08/2020,20200608,202006,2020.23,2020,PPL,Debit-Card,-933,3823,misc,"None,"
06/05/2020,20200605,202006,2020.22,2020,Cognizant Technology Solutions,Debit-Card,842,4756,invest,"None,"
06/05/2020,20200605,202006,2020.22,2020,Travelers,Debit-Card,-215,3914,health,"None,"
06/04/2020,20200604,202006,2020.22,2020,Amazon.com,Debit-Card,-899,4129,grocery,"None,"
06/03/2020,20200603,202006,2020.22,2020,PPL,Debit-Card,-817,5028,health,"None,"
06/02/2020,20200602,202006,2020.22,2020,Tapestry,Debit-Card,-135,5845,debt,"None,"
06/02/2020,20200602,202006,2020.22,2020,TIAA,Debit-Card,200,5980,debt,"None,"
06/02/2020,20200602,202006,2020.22,2020,TIAA,Debit-Card,-623,5780,clothing,"None,"
06/01/2020,20200601,202006,2020.22,2020,TIAA,Debit-Card,394,6403,clothing,"None,"
06/01/2020,20200601,202006,2020.22,2020,Sysco,Debit-Card,363,6009,grocery,"None,"
06/01/2020,20200601,202006,2020.22,2020,TIAA,Debit-Card,251,5646,clothing,"None,"
06/01/2020,20200601,202006,2020.22,2020,TIAA,Debit-Card,-901,5395,misc,"None,"
05/29/2020,20200529,202005,2020.21,2020,Omnicom Group,Debit-Card,562,6296,misc,"None,"
05/29/2020,20200529,202005,2020.21,2020,Hershey,Debit-Card,925,5734,clothing,"None,"
05/28/2020,20200528,202005,2020.21,2020,Delta Air Lines,Debit-Card,320,4809,grocery,"None,"
05/27/2020,20200527,202005,2020.21,2020,Walmart,Debit-Card,-285,4489,paypal,"None,"
05/26/2020,20200526,202005,2020.21,2020,Amazon.com,Debit-Card,673,4774,paypal,"None,"
05/26/2020,20200526,202005,2020.21,2020,Travelers,Debit-Card,-952,4101,unk,"None,"
05/26/2020,20200526,202005,2020.21,2020,Ulta Beauty,Debit-Card,288,5053,tech,"None,"
05/22/2020,20200522,202005,2020.2,2020,Entergy,Debit-Card,-663,4765,tech,"None,"
05/22/2020,20200522,202005,2020.2,2020,PPL,Debit-Card,873,5428,invest,"None,"
05/20/2020,20200520,202005,2020.2,2020,Walmart,Debit-Card,118,4555,debt,"None,"
05/20/2020,20200520,202005,2020.2,2020,Delta Air Lines,Debit-Card,832,4437,tech,"None,"
05/19/2020,20200519,202005,2020.2,2020,Hanesbrands,Debit-Card,-941,3605,travel,"None,"
05/18/2020,20200518,202005,2020.2,2020,Visa,Debit-Card,846,4546,invest,"None,"
05/18/2020,20200518,202005,2020.2,2020,Omnicom Group,Debit-Card,-459,3700,health,"None,"
05/18/2020,20200518,202005,2020.2,2020,Delta Air Lines,Debit-Card,946,4159,paypal,"None,"
05/18/2020,20200518,202005,2020.2,2020,Quest Diagnostics,Debit-Card,-736,3213,paypal,"None,"
05/18/2020,20200518,202005,2020.2,2020,Amazon.com,Debit-Card,-492,3949,unk,"None,"
05/15/2020,20200515,202005,2020.19,2020,Omnicom Group,Debit-Card,-916,4441,grocery,"None,"
05/15/2020,20200515,202005,2020.19,2020,Travelers,Debit-Card,745,5357,tech,"None,"
05/14/2020,20200514,202005,2020.19,2020,Hanesbrands,Debit-Card,-499,4612,invest,"None,"
05/14/2020,20200514,202005,2020.19,2020,CBRE Group,Debit-Card,467,5111,health,"None,"
05/13/2020,20200513,202005,2020.19,2020,Omnicom Group,Debit-Card,-430,4644,grocery,"None,"
05/12/2020,20200512,202005,2020.19,2020,Delta Air Lines,Debit-Card,-896,5074,grocery,"None,"
05/11/2020,20200511,202005,2020.19,2020,CBRE Group,Debit-Card,189,5970,unk,"None,"
05/11/2020,20200511,202005,2020.19,2020,Quest Diagnostics,Debit-Card,-395,5781,unk,"None,"
05/11/2020,20200511,202005,2020.19,2020,Hanesbrands,Debit-Card,154,6176,tech,"None,"
05/11/2020,20200511,202005,2020.19,2020,Hanesbrands,Debit-Card,-733,6022,health,"None,"
05/11/2020,20200511,202005,2020.19,2020,Hanesbrands,Debit-Card,728,6755,travel,"None,"
05/08/2020,20200508,202005,2020.18,2020,Tapestry,Debit-Card,20,6027,travel,"None,"
05/07/2020,20200507,202005,2020.18,2020,Amazon.com,Debit-Card,800,6007,unk,"None,"
05/07/2020,20200507,202005,2020.18,2020,Ulta Beauty,Debit-Card,-140,5207,debt,"None,"
05/06/2020,20200506,202005,2020.18,2020,Visa,Debit-Card,296,5347,unk,"None,"
05/05/2020,20200505,202005,2020.18,2020,Hanesbrands,Debit-Card,75,5051,tech,"None,"
05/05/2020,20200505,202005,2020.18,2020,PPL,Debit-Card,491,4976,tech,"None,"
05/04/2020,20200504,202005,2020.18,2020,TIAA,Debit-Card,263,4485,invest,"None,"
05/04/2020,20200504,202005,2020.18,2020,Tapestry,Debit-Card,402,4222,utility,"None,"
05/04/2020,20200504,202005,2020.18,2020,Visa,Debit-Card,-260,3820,unk,"None,"
05/04/2020,20200504,202005,2020.18,2020,Walmart,Debit-Card,244,4080,invest,"None,"
04/30/2020,20200430,202004,2020.17,2020,PPL,Debit-Card,-342,3836,debt,"None,"
04/30/2020,20200430,202004,2020.17,2020,Hewlett Packard Enterprise,Debit-Card,-247,4178,unk,"None,"
04/29/2020,20200429,202004,2020.17,2020,TIAA,Debit-Card,-157,4425,debt,"None,"
04/27/2020,20200427,202004,2020.17,2020,PPL,Debit-Card,-592,4582,health,"None,"
04/27/2020,20200427,202004,2020.17,2020,Cognizant Technology Solutions,Debit-Card,-680,5174,travel,"None,"
04/24/2020,20200424,202004,2020.16,2020,Amazon.com,Debit-Card,-892,5854,unk,"None,"
04/24/2020,20200424,202004,2020.16,2020,United Continental Holdings,Debit-Card,-737,6746,grocery,"None,"
04/23/2020,20200423,202004,2020.16,2020,Cognizant Technology Solutions,Debit-Card,395,7483,clothing,"None,"
04/22/2020,20200422,202004,2020.16,2020,Omnicom Group,Debit-Card,-334,7088,utility,"None,"
04/22/2020,20200422,202004,2020.16,2020,Amazon.com,Debit-Card,234,7422,health,"None,"
04/21/2020,20200421,202004,2020.16,2020,Entergy,Debit-Card,-898,7188,unk,"None,"
04/21/2020,20200421,202004,2020.16,2020,TIAA,Debit-Card,-596,8086,utility,"None,"
04/20/2020,20200420,202004,2020.16,2020,CBRE Group,Debit-Card,124,8682,health,"None,"
04/20/2020,20200420,202004,2020.16,2020,Voya Financial,Debit-Card,600,8558,paypal,"None,"
04/20/2020,20200420,202004,2020.16,2020,Visa,Debit-Card,4,7958,travel,"None,"
04/20/2020,20200420,202004,2020.16,2020,Walmart,Debit-Card,-639,7954,unk,"None,"
04/20/2020,20200420,202004,2020.16,2020,CBRE Group,Debit-Card,-217,8593,misc,"None,"
04/20/2020,20200420,202004,2020.16,2020,Delta Air Lines,Debit-Card,-745,8810,travel,"None,"
04/17/2020,20200417,202004,2020.15,2020,United Continental Holdings,Debit-Card,188,9555,misc,"None,"
04/16/2020,20200416,202004,2020.15,2020,Hewlett Packard Enterprise,Debit-Card,97,9367,grocery,"None,"
04/16/2020,20200416,202004,2020.15,2020,Amazon.com,Debit-Card,691,9270,paypal,"None,"
04/16/2020,20200416,202004,2020.15,2020,Voya Financial,Debit-Card,-245,8579,unk,"None,"
04/16/2020,20200416,202004,2020.15,2020,PPL,Debit-Card,-330,8824,misc,"None,"
04/15/2020,20200415,202004,2020.15,2020,CBRE Group,Debit-Card,-451,9154,utility,"None,"
04/15/2020,20200415,202004,2020.15,2020,Delta Air Lines,Debit-Card,-63,9605,health,"None,"
04/14/2020,20200414,202004,2020.15,2020,Hewlett Packard Enterprise,Debit-Card,931,9668,utility,"None,"
04/14/2020,20200414,202004,2020.15,2020,Quest Diagnostics,Debit-Card,297,8737,clothing,"None,"
04/13/2020,20200413,202004,2020.15,2020,Hershey,Debit-Card,-763,8440,health,"None,"
04/13/2020,20200413,202004,2020.15,2020,Walmart,Debit-Card,997,9203,tech,"None,"
04/13/2020,20200413,202004,2020.15,2020,Quest Diagnostics,Debit-Card,-784,8206,clothing,"None,"
04/13/2020,20200413,202004,2020.15,2020,CBRE Group,Debit-Card,179,8990,invest,"None,"
04/10/2020,20200410,202004,2020.14,2020,Amazon.com,Debit-Card,792,8811,grocery,"None,"
04/10/2020,20200410,202004,2020.14,2020,Amazon.com,Debit-Card,-143,8019,utility,"None,"
04/10/2020,20200410,202004,2020.14,2020,Ulta Beauty,Debit-Card,-260,8162,paypal,"None,"
04/10/2020,20200410,202004,2020.14,2020,Amazon.com,Debit-Card,-884,8422,debt,"None,"
04/07/2020,20200407,202004,2020.14,2020,Entergy,Debit-Card,675,9306,grocery,"None,"
04/07/2020,20200407,202004,2020.14,2020,Voya Financial,Debit-Card,-691,8631,misc,"None,"
04/07/2020,20200407,202004,2020.14,2020,United Continental Holdings,Debit-Card,-814,9322,health,"None,"
04/07/2020,20200407,202004,2020.14,2020,Amazon.com,Debit-Card,-774,10136,paypal,"None,"
04/06/2020,20200406,202004,2020.14,2020,Delta Air Lines,Debit-Card,690,10910,grocery,"None,"
04/06/2020,20200406,202004,2020.14,2020,Entergy,Debit-Card,-14,10220,grocery,"None,"
04/06/2020,20200406,202004,2020.14,2020,Hewlett Packard Enterprise,Debit-Card,465,10234,grocery,"None,"
04/03/2020,20200403,202004,2020.13,2020,CBRE Group,Debit-Card,-676,9769,health,"None,"
04/02/2020,20200402,202004,2020.13,2020,Entergy,Debit-Card,740,10445,unk,"None,"
04/02/2020,20200402,202004,2020.13,2020,United Continental Holdings,Debit-Card,-55,9705,misc,"None,"
04/02/2020,20200402,202004,2020.13,2020,United Continental Holdings,Debit-Card,525,9760,misc,"None,"
04/01/2020,20200401,202004,2020.13,2020,Sysco,Debit-Card,-264,9235,health,"None,"
03/31/2020,20200331,202003,2020.13,2020,Walmart,Debit-Card,-587,9499,grocery,"None,"
03/31/2020,20200331,202003,2020.13,2020,Travelers,Debit-Card,694,10086,travel,"None,"
03/31/2020,20200331,202003,2020.13,2020,Ulta Beauty,Debit-Card,878,9392,invest,"None,"
03/30/2020,20200330,202003,2020.13,2020,Hewlett Packard Enterprise,Debit-Card,197,8514,travel,"None,"
03/30/2020,20200330,202003,2020.13,2020,Hewlett Packard Enterprise,Debit-Card,-480,8317,health,"None,"
03/30/2020,20200330,202003,2020.13,2020,United Continental Holdings,Debit-Card,398,8797,unk,"None,"
03/25/2020,20200325,202003,2020.12,2020,Hanesbrands,Debit-Card,940,8399,unk,"None,"
03/24/2020,20200324,202003,2020.12,2020,Visa,Debit-Card,-985,7459,unk,"None,"
03/23/2020,20200323,202003,2020.12,2020,CBRE Group,Debit-Card,227,8444,tech,"None,"
03/23/2020,20200323,202003,2020.12,2020,United Continental Holdings,Debit-Card,-87,8217,invest,"None,"
03/23/2020,20200323,202003,2020.12,2020,Entergy,Debit-Card,767,8304,unk,"None,"
03/20/2020,20200320,202003,2020.11,2020,Travelers,Debit-Card,-689,7537,clothing,"None,"
03/20/2020,20200320,202003,2020.11,2020,Travelers,Debit-Card,-17,8226,unk,"None,"
03/18/2020,20200318,202003,2020.11,2020,PPL,Debit-Card,742,8243,debt,"None,"
03/18/2020,20200318,202003,2020.11,2020,Omnicom Group,Debit-Card,20,7501,paypal,"None,"
03/18/2020,20200318,202003,2020.11,2020,Omnicom Group,Debit-Card,603,7481,misc,"None,"
03/18/2020,20200318,202003,2020.11,2020,Visa,Debit-Card,892,6878,health,"None,"
03/17/2020,20200317,202003,2020.11,2020,Cognizant Technology Solutions,Debit-Card,-953,5986,debt,"None,"
03/16/2020,20200316,202003,2020.11,2020,TIAA,Debit-Card,-477,6939,travel,"None,"
03/16/2020,20200316,202003,2020.11,2020,Delta Air Lines,Debit-Card,234,7416,grocery,"None,"
03/16/2020,20200316,202003,2020.11,2020,Delta Air Lines,Debit-Card,491,7182,debt,"None,"
03/16/2020,20200316,202003,2020.11,2020,United Continental Holdings,Debit-Card,266,6691,misc,"None,"
03/16/2020,20200316,202003,2020.11,2020,Tapestry,Debit-Card,581,6425,misc,"None,"
03/16/2020,20200316,202003,2020.11,2020,Amazon.com,Debit-Card,-5,5844,unk,"None,"
03/16/2020,20200316,202003,2020.11,2020,Ulta Beauty,Debit-Card,-642,5849,misc,"None,"
03/16/2020,20200316,202003,2020.11,2020,Cognizant Technology Solutions,Debit-Card,-159,6491,utility,"None,"
03/16/2020,20200316,202003,2020.11,2020,CBRE Group,Debit-Card,-87,6650,debt,"None,"
03/13/2020,20200313,202003,2020.1,2020,Voya Financial,Debit-Card,-905,6737,clothing,"None,"
03/13/2020,20200313,202003,2020.1,2020,Amazon.com,Debit-Card,-661,7642,tech,"None,"
03/13/2020,20200313,202003,2020.1,2020,Tapestry,Debit-Card,966,8303,invest,"None,"
03/12/2020,20200312,202003,2020.1,2020,PPL,Debit-Card,50,7337,tech,"None,"
03/12/2020,20200312,202003,2020.1,2020,Tapestry,Debit-Card,727,7287,health,"None,"
03/12/2020,20200312,202003,2020.1,2020,CBRE Group,Debit-Card,336,6560,invest,"None,"
03/12/2020,20200312,202003,2020.1,2020,Omnicom Group,Debit-Card,-399,6224,clothing,"None,"
03/11/2020,20200311,202003,2020.1,2020,Cognizant Technology Solutions,Debit-Card,764,6623,unk,"None,"
03/11/2020,20200311,202003,2020.1,2020,Hewlett Packard Enterprise,Debit-Card,59,5859,paypal,"None,"
03/10/2020,20200310,202003,2020.1,2020,TIAA,Debit-Card,599,5800,misc,"None,"
03/10/2020,20200310,202003,2020.1,2020,Walmart,Debit-Card,728,5201,unk,"None,"
03/10/2020,20200310,202003,2020.1,2020,Walmart,Debit-Card,598,4473,clothing,"None,"
03/10/2020,20200310,202003,2020.1,2020,Voya Financial,Debit-Card,22,3875,paypal,"None,"
03/09/2020,20200309,202003,2020.1,2020,Hewlett Packard Enterprise,Debit-Card,-602,3853,misc,"None,"
03/09/2020,20200309,202003,2020.1,2020,United Continental Holdings,Debit-Card,-135,4455,invest,"None,"
03/09/2020,20200309,202003,2020.1,2020,Visa,Debit-Card,80,4590,travel,"None,"
03/09/2020,20200309,202003,2020.1,2020,Amazon.com,Debit-Card,-532,4510,debt,"None,"
03/09/2020,20200309,202003,2020.1,2020,Hershey,Debit-Card,811,5042,utility,"None,"
03/09/2020,20200309,202003,2020.1,2020,United Continental Holdings,Debit-Card,163,4231,travel,"None,"
03/06/2020,20200306,202003,2020.09,2020,Tapestry,Debit-Card,733,4068,grocery,"None,"
03/06/2020,20200306,202003,2020.09,2020,Amazon.com,Debit-Card,825,3335,travel,"None,"
03/06/2020,20200306,202003,2020.09,2020,Hewlett Packard Enterprise,Debit-Card,719,2510,utility,"None,"
03/05/2020,20200305,202003,2020.09,2020,Delta Air Lines,Debit-Card,-619,1791,invest,"None,"
03/05/2020,20200305,202003,2020.09,2020,Visa,Debit-Card,172,2410,tech,"None,"
03/05/2020,20200305,202003,2020.09,2020,Quest Diagnostics,Debit-Card,-764,2238,grocery,"None,"
03/03/2020,20200303,202003,2020.09,2020,United Continental Holdings,Debit-Card,-746,3002,grocery,"None,"
03/02/2020,20200302,202003,2020.09,2020,TIAA,Debit-Card,702,3748,paypal,"None,"
03/02/2020,20200302,202003,2020.09,2020,Hewlett Packard Enterprise,Debit-Card,-76,3046,utility,"None,"
03/02/2020,20200302,202003,2020.09,2020,Delta Air Lines,Debit-Card,-797,3122,misc,"None,"
03/02/2020,20200302,202003,2020.09,2020,PPL,Debit-Card,-881,3919,misc,"None,"
03/02/2020,20200302,202003,2020.09,2020,Visa,Debit-Card,977,4800,debt,"None,"
03/02/2020,20200302,202003,2020.09,2020,Hershey,Debit-Card,-493,3823,invest,"None,"
03/02/2020,20200302,202003,2020.09,2020,Delta Air Lines,Debit-Card,958,4316,travel,"None,"
03/02/2020,20200302,202003,2020.09,2020,Delta Air Lines,Debit-Card,574,3358,invest,"None,"
02/28/2020,20200228,202002,2020.08,2020,United Continental Holdings,Debit-Card,-386,2784,unk,"None,"
02/28/2020,20200228,202002,2020.08,2020,Omnicom Group,Debit-Card,704,3170,misc,"None,"
02/28/2020,20200228,202002,2020.08,2020,Walmart,Debit-Card,983,2466,health,"None,"
02/28/2020,20200228,202002,2020.08,2020,Hanesbrands,Debit-Card,-367,1483,paypal,"None,"
02/28/2020,20200228,202002,2020.08,2020,Hershey,Debit-Card,182,1850,misc,"None,"
02/27/2020,20200227,202002,2020.08,2020,Quest Diagnostics,Debit-Card,42,1668,invest,"None,"
02/27/2020,20200227,202002,2020.08,2020,Hershey,Debit-Card,533,1626,health,"None,"
02/25/2020,20200225,202002,2020.08,2020,Hewlett Packard Enterprise,Debit-Card,457,1093,grocery,"None,"
02/25/2020,20200225,202002,2020.08,2020,Walmart,Debit-Card,-492,636,misc,"None,"
02/25/2020,20200225,202002,2020.08,2020,Entergy,Debit-Card,975,1128,health,"None,"
02/24/2020,20200224,202002,2020.08,2020,Entergy,Debit-Card,-38,153,tech,"None,"
02/24/2020,20200224,202002,2020.08,2020,Voya Financial,Debit-Card,833,191,tech,"None,"
02/24/2020,20200224,202002,2020.08,2020,Voya Financial,Debit-Card,949,-642,unk,"None,"
02/24/2020,20200224,202002,2020.08,2020,Entergy,Debit-Card,587,-1591,invest,"None,"
02/24/2020,20200224,202002,2020.08,2020,Omnicom Group,Debit-Card,-29,-2178,tech,"None,"
02/24/2020,20200224,202002,2020.08,2020,CBRE Group,Debit-Card,-543,-2149,debt,"None,"
02/24/2020,20200224,202002,2020.08,2020,Amazon.com,Debit-Card,-944,-1606,grocery,"None,"
02/24/2020,20200224,202002,2020.08,2020,United Continental Holdings,Debit-Card,551,-662,misc,"None,"
02/24/2020,20200224,202002,2020.08,2020,Voya Financial,Debit-Card,700,-1213,travel,"None,"
02/24/2020,20200224,202002,2020.08,2020,TIAA,Debit-Card,243,-1913,grocery,"None,"
02/20/2020,20200220,202002,2020.07,2020,Hershey,Debit-Card,-901,-2156,misc,"None,"
02/20/2020,20200220,202002,2020.07,2020,Amazon.com,Debit-Card,-568,-1255,tech,"None,"
02/20/2020,20200220,202002,2020.07,2020,Hanesbrands,Debit-Card,-379,-687,invest,"None,"
02/19/2020,20200219,202002,2020.07,2020,Hewlett Packard Enterprise,Debit-Card,792,-308,health,"None,"
02/19/2020,20200219,202002,2020.07,2020,Hanesbrands,Debit-Card,-319,-1100,health,"None,"
02/18/2020,20200218,202002,2020.07,2020,Omnicom Group,Debit-Card,-973,-781,unk,"None,"
02/18/2020,20200218,202002,2020.07,2020,Delta Air Lines,Debit-Card,463,192,tech,"None,"
02/18/2020,20200218,202002,2020.07,2020,Omnicom Group,Debit-Card,-379,-271,grocery,"None,"
02/18/2020,20200218,202002,2020.07,2020,Sysco,Debit-Card,-775,108,misc,"None,"
02/18/2020,20200218,202002,2020.07,2020,Walmart,Debit-Card,179,883,tech,"None,"
02/18/2020,20200218,202002,2020.07,2020,CBRE Group,Debit-Card,-174,704,travel,"None,"
02/18/2020,20200218,202002,2020.07,2020,Delta Air Lines,Debit-Card,103,878,invest,"None,"
02/18/2020,20200218,202002,2020.07,2020,Entergy,Debit-Card,303,775,invest,"None,"
02/14/2020,20200214,202002,2020.06,2020,Sysco,Debit-Card,-155,472,health,"None,"
02/14/2020,20200214,202002,2020.06,2020,Sysco,Debit-Card,-448,627,paypal,"None,"
02/14/2020,20200214,202002,2020.06,2020,Travelers,Debit-Card,406,1075,unk,"None,"
02/14/2020,20200214,202002,2020.06,2020,Entergy,Debit-Card,-607,669,misc,"None,"
02/14/2020,20200214,202002,2020.06,2020,Quest Diagnostics,Debit-Card,950,1276,utility,"None,"
02/12/2020,20200212,202002,2020.06,2020,Amazon.com,Debit-Card,549,326,health,"None,"
02/12/2020,20200212,202002,2020.06,2020,Walmart,Debit-Card,904,-223,unk,"None,"
02/11/2020,20200211,202002,2020.06,2020,Omnicom Group,Debit-Card,-953,-1127,invest,"None,"
02/11/2020,20200211,202002,2020.06,2020,Amazon.com,Debit-Card,-165,-174,health,"None,"
02/10/2020,20200210,202002,2020.06,2020,Entergy,Debit-Card,677,-9,invest,"None,"
02/10/2020,20200210,202002,2020.06,2020,Delta Air Lines,Debit-Card,894,-686,tech,"None,"
02/10/2020,20200210,202002,2020.06,2020,Quest Diagnostics,Debit-Card,601,-1580,invest,"None,"
02/10/2020,20200210,202002,2020.06,2020,TIAA,Debit-Card,-36,-2181,health,"None,"
02/10/2020,20200210,202002,2020.06,2020,CBRE Group,Debit-Card,-494,-2145,tech,"None,"
02/10/2020,20200210,202002,2020.06,2020,Amazon.com,Debit-Card,-957,-1651,tech,"None,"
02/10/2020,20200210,202002,2020.06,2020,Travelers,Debit-Card,-566,-694,travel,"None,"
02/07/2020,20200207,202002,2020.05,2020,Tapestry,Debit-Card,424,-128,health,"None,"
02/07/2020,20200207,202002,2020.05,2020,Delta Air Lines,Debit-Card,991,-552,grocery,"None,"
02/07/2020,20200207,202002,2020.05,2020,Walmart,Debit-Card,-577,-1543,unk,"None,"
02/07/2020,20200207,202002,2020.05,2020,Ulta Beauty,Debit-Card,-563,-966,health,"None,"
02/06/2020,20200206,202002,2020.05,2020,United Continental Holdings,Debit-Card,230,-403,unk,"None,"
02/06/2020,20200206,202002,2020.05,2020,Amazon.com,Debit-Card,-418,-633,invest,"None,"
02/06/2020,20200206,202002,2020.05,2020,Hanesbrands,Debit-Card,755,-215,unk,"None,"
02/04/2020,20200204,202002,2020.05,2020,Entergy,Debit-Card,218,-970,health,"None,"
02/04/2020,20200204,202002,2020.05,2020,PPL,Debit-Card,-913,-1188,health,"None,"
02/04/2020,20200204,202002,2020.05,2020,Voya Financial,Debit-Card,-763,-275,misc,"None,"
02/03/2020,20200203,202002,2020.05,2020,Sysco,Debit-Card,-725,488,health,"None,"
02/03/2020,20200203,202002,2020.05,2020,Hewlett Packard Enterprise,Debit-Card,995,1213,health,"None,"
02/03/2020,20200203,202002,2020.05,2020,Ulta Beauty,Debit-Card,-917,218,travel,"None,"
02/03/2020,20200203,202002,2020.05,2020,Travelers,Debit-Card,-182,1135,travel,"None,"
02/03/2020,20200203,202002,2020.05,2020,PPL,Debit-Card,201,1317,tech,"None,"
01/31/2020,20200131,202001,2020.04,2020,Visa,Debit-Card,-681,1116,grocery,"None,"
01/31/2020,20200131,202001,2020.04,2020,United Continental Holdings,Debit-Card,64,1797,invest,"None,"
01/31/2020,20200131,202001,2020.04,2020,Ulta Beauty,Debit-Card,20,1733,paypal,"None,"
01/31/2020,20200131,202001,2020.04,2020,Amazon.com,Debit-Card,-9,1713,health,"None,"
01/30/2020,20200130,202001,2020.04,2020,Walmart,Debit-Card,-319,1722,health,"None,"
01/28/2020,20200128,202001,2020.04,2020,CBRE Group,Debit-Card,276,2041,travel,"None,"
01/28/2020,20200128,202001,2020.04,2020,Walmart,Debit-Card,-226,1765,grocery,"None,"
01/28/2020,20200128,202001,2020.04,2020,United Continental Holdings,Debit-Card,861,1991,grocery,"None,"
01/27/2020,20200127,202001,2020.04,2020,Ulta Beauty,Debit-Card,614,1130,grocery,"None,"
01/27/2020,20200127,202001,2020.04,2020,Quest Diagnostics,Debit-Card,-950,516,invest,"None,"
01/27/2020,20200127,202001,2020.04,2020,PPL,Debit-Card,-131,1466,invest,"None,"
01/27/2020,20200127,202001,2020.04,2020,Delta Air Lines,Debit-Card,-38,1597,health,"None,"
01/27/2020,20200127,202001,2020.04,2020,Amazon.com,Debit-Card,-109,1635,health,"None,"
01/24/2020,20200124,202001,2020.03,2020,CBRE Group,Debit-Card,-154,1744,tech,"None,"
01/22/2020,20200122,202001,2020.03,2020,Sysco,Debit-Card,291,1898,grocery,"None,"
01/22/2020,20200122,202001,2020.03,2020,Sysco,Debit-Card,344,1607,debt,"None,"
01/21/2020,20200121,202001,2020.03,2020,CBRE Group,Debit-Card,-366,1263,invest,"None,"
01/21/2020,20200121,202001,2020.03,2020,Cognizant Technology Solutions,Debit-Card,190,1629,unk,"None,"
01/21/2020,20200121,202001,2020.03,2020,Voya Financial,Debit-Card,-360,1439,travel,"None,"
01/21/2020,20200121,202001,2020.03,2020,Tapestry,Debit-Card,-916,1799,utility,"None,"
01/21/2020,20200121,202001,2020.03,2020,CBRE Group,Debit-Card,-967,2715,health,"None,"
01/21/2020,20200121,202001,2020.03,2020,CBRE Group,Debit-Card,-3,3682,travel,"None,"
01/17/2020,20200117,202001,2020.02,2020,PPL,Debit-Card,-831,3685,paypal,"None,"
01/17/2020,20200117,202001,2020.02,2020,CBRE Group,Debit-Card,-252,4516,unk,"None,"
01/17/2020,20200117,202001,2020.02,2020,Entergy,Debit-Card,-746,4768,grocery,"None,"
01/17/2020,20200117,202001,2020.02,2020,Ulta Beauty,Debit-Card,-642,5514,health,"None,"
01/17/2020,20200117,202001,2020.02,2020,Entergy,Debit-Card,-194,6156,utility,"None,"
01/16/2020,20200116,202001,2020.02,2020,Walmart,Debit-Card,-671,6350,invest,"None,"
01/15/2020,20200115,202001,2020.02,2020,Travelers,Debit-Card,-507,7021,tech,"None,"
01/15/2020,20200115,202001,2020.02,2020,Hanesbrands,Debit-Card,-995,7528,misc,"None,"
01/14/2020,20200114,202001,2020.02,2020,United Continental Holdings,Debit-Card,180,8523,unk,"None,"
01/14/2020,20200114,202001,2020.02,2020,Delta Air Lines,Debit-Card,-222,8343,misc,"None,"
01/13/2020,20200113,202001,2020.02,2020,TIAA,Debit-Card,-317,8565,invest,"None,"
01/13/2020,20200113,202001,2020.02,2020,PPL,Debit-Card,-244,8882,tech,"None,"
01/13/2020,20200113,202001,2020.02,2020,TIAA,Debit-Card,457,9126,tech,"None,"
01/13/2020,20200113,202001,2020.02,2020,Delta Air Lines,Debit-Card,-654,8669,tech,"None,"
01/13/2020,20200113,202001,2020.02,2020,CBRE Group,Debit-Card,337,9323,tech,"None,"
01/10/2020,20200110,202001,2020.01,2020,Hershey,Debit-Card,-227,8986,health,"None,"
01/10/2020,20200110,202001,2020.01,2020,PPL,Debit-Card,228,9213,travel,"None,"
01/10/2020,20200110,202001,2020.01,2020,Amazon.com,Debit-Card,-137,8985,grocery,"None,"
01/08/2020,20200108,202001,2020.01,2020,TIAA,Debit-Card,-871,9122,invest,"None,"
01/07/2020,20200107,202001,2020.01,2020,Hershey,Debit-Card,-765,9993,clothing,"None,"
01/06/2020,20200106,202001,2020.01,2020,Hewlett Packard Enterprise,Debit-Card,-681,10758,misc,"None,"
01/06/2020,20200106,202001,2020.01,2020,Travelers,Debit-Card,-645,11439,grocery,"None,"
01/06/2020,20200106,202001,2020.01,2020,Walmart,Debit-Card,642,12084,invest,"None,"
01/06/2020,20200106,202001,2020.01,2020,Entergy,Debit-Card,282,11442,clothing,"None,"
01/03/2020,20200103,202001,2020.0,2020,Delta Air Lines,Debit-Card,-448,11160,travel,"None,"
01/03/2020,20200103,202001,2020.0,2020,Hershey,Debit-Card,309,11608,misc,"None,"
01/02/2020,20200102,202001,2020.0,2020,Visa,Debit-Card,287,11299,invest,"None,"
01/02/2020,20200102,202001,2020.0,2020,Ulta Beauty,Debit-Card,510,11012,misc,"None,"
01/02/2020,20200102,202001,2020.0,2020,PPL,Debit-Card,502,10502,health,"None,"
01/02/2020,20200102,202001,2020.0,2020,Hanesbrands,Debit-Card,698,10000,invest,"None,"
