Date,YYYYMMDD,YYYYMM,YYYY.W,YYYY,Location,Card,Delta,Balance,Category,Tags
09/22/2022,20220922,202209,2022.38,2022,Hewlett Packard Enterprise,Debit-Card,-646,1236,health,"None,"
09/22/2022,20220922,202209,2022.38,2022,Hewlett Packard Enterprise,Debit-Card,-500,1882,health,"None,"
09/22/2022,20220922,202209,2022.38,2022,Travelers,Debit-Card,-904,2382,invest,"None,"
09/22/2022,20220922,202209,2022.38,2022,Voya Financial,Debit-Card,-570,3286,unk,"None,"
09/21/2022,20220921,202209,2022.38,2022,Visa,Debit-Card,488,3856,tech,"None,"
09/20/2022,20220920,202209,2022.38,2022,Voya Financial,Debit-Card,-818,3368,clothing,"None,"
09/20/2022,20220920,202209,2022.38,2022,Tapestry,Debit-Card,853,4186,invest,"None,"
09/20/2022,20220920,202209,2022.38,2022,Sysco,Debit-Card,387,3333,health,"None,"
09/19/2022,20220919,202209,2022.38,2022,TIAA,Debit-Card,840,2946,unk,"None,"
09/19/2022,20220919,202209,2022.38,2022,Delta Air Lines,Debit-Card,-3,2106,misc,"None,"
09/19/2022,20220919,202209,2022.38,2022,Walmart,Debit-Card,-820,2109,unk,"None,"
09/19/2022,20220919,202209,2022.38,2022,Quest Diagnostics,Debit-Card,950,2929,clothing,"None,"
09/19/2022,20220919,202209,2022.38,2022,Hershey,Debit-Card,93,1979,travel,"None,"
09/19/2022,20220919,202209,2022.38,2022,Hershey,Debit-Card,-435,1886,invest,"None,"
09/19/2022,20220919,202209,2022.38,2022,Tapestry,Debit-Card,110,2321,grocery,"None,"
09/19/2022,20220919,202209,2022.38,2022,Travelers,Debit-Card,-278,2211,grocery,"None,"
09/19/2022,20220919,202209,2022.38,2022,Cognizant Technology Solutions,Debit-Card,-910,2489,travel,"None,"
09/19/2022,20220919,202209,2022.38,2022,United Continental Holdings,Debit-Card,829,3399,debt,"None,"
09/19/2022,20220919,202209,2022.38,2022,Omnicom Group,Debit-Card,729,2570,invest,"None,"
09/19/2022,20220919,202209,2022.38,2022,Walmart,Debit-Card,-745,1841,travel,"None,"
09/19/2022,20220919,202209,2022.38,2022,Visa,Debit-Card,967,2586,invest,"None,"
09/16/2022,20220916,202209,2022.37,2022,Travelers,Debit-Card,943,1619,paypal,"None,"
09/16/2022,20220916,202209,2022.37,2022,Walmart,Debit-Card,128,676,health,"None,"
09/16/2022,20220916,202209,2022.37,2022,Hanesbrands,Debit-Card,158,548,tech,"None,"
09/16/2022,20220916,202209,2022.37,2022,Walmart,Debit-Card,-214,390,health,"None,"
09/16/2022,20220916,202209,2022.37,2022,Walmart,Debit-Card,-318,604,travel,"None,"
09/15/2022,20220915,202209,2022.37,2022,United Continental Holdings,Debit-Card,-573,922,health,"None,"
09/15/2022,20220915,202209,2022.37,2022,Hewlett Packard Enterprise,Debit-Card,-881,1495,utility,"None,"
09/15/2022,20220915,202209,2022.37,2022,Walmart,Debit-Card,-998,2376,travel,"None,"
09/14/2022,20220914,202209,2022.37,2022,Travelers,Debit-Card,-371,3374,unk,"None,"
09/14/2022,20220914,202209,2022.37,2022,Travelers,Debit-Card,53,3745,unk,"None,"
09/13/2022,20220913,202209,2022.37,2022,Travelers,Debit-Card,-5,3692,grocery,"None,"
09/13/2022,20220913,202209,2022.37,2022,TIAA,Debit-Card,-987,3697,grocery,"None,"
09/13/2022,20220913,202209,2022.37,2022,Hanesbrands,Debit-Card,-413,4684,tech,"None,"
09/13/2022,20220913,202209,2022.37,2022,United Continental Holdings,Debit-Card,331,5097,misc,"None,"
09/13/2022,20220913,202209,2022.37,2022,Voya Financial,Debit-Card,251,4766,clothing,"None,"
09/12/2022,20220912,202209,2022.37,2022,Sysco,Debit-Card,879,4515,health,"None,"
09/12/2022,20220912,202209,2022.37,2022,Ulta Beauty,Debit-Card,3,3636,utility,"None,"
09/12/2022,20220912,202209,2022.37,2022,Delta Air Lines,Debit-Card,966,3633,clothing,"None,"
09/12/2022,20220912,202209,2022.37,2022,Hershey,Debit-Card,-296,2667,invest,"None,"
09/12/2022,20220912,202209,2022.37,2022,PPL,Debit-Card,-960,2963,invest,"None,"
09/12/2022,20220912,202209,2022.37,2022,Amazon.com,Debit-Card,765,3923,tech,"None,"
09/12/2022,20220912,202209,2022.37,2022,TIAA,Debit-Card,354,3158,utility,"None,"
09/12/2022,20220912,202209,2022.37,2022,Tapestry,Debit-Card,-600,2804,unk,"None,"
09/12/2022,20220912,202209,2022.37,2022,Entergy,Debit-Card,222,3404,invest,"None,"
09/12/2022,20220912,202209,2022.37,2022,Sysco,Debit-Card,99,3182,unk,"None,"
09/12/2022,20220912,202209,2022.37,2022,Travelers,Debit-Card,-801,3083,health,"None,"
09/12/2022,20220912,202209,2022.37,2022,Omnicom Group,Debit-Card,823,3884,health,"None,"
09/09/2022,20220909,202209,2022.36,2022,TIAA,Debit-Card,296,3061,invest,"None,"
09/09/2022,20220909,202209,2022.36,2022,Omnicom Group,Debit-Card,-19,2765,unk,"None,"
09/09/2022,20220909,202209,2022.36,2022,Amazon.com,Debit-Card,-783,2784,unk,"None,"
09/09/2022,20220909,202209,2022.36,2022,Hanesbrands,Debit-Card,-212,3567,invest,"None,"
09/09/2022,20220909,202209,2022.36,2022,United Continental Holdings,Debit-Card,-822,3779,paypal,"None,"
09/08/2022,20220908,202209,2022.36,2022,Delta Air Lines,Debit-Card,620,4601,travel,"None,"
09/08/2022,20220908,202209,2022.36,2022,Amazon.com,Debit-Card,196,3981,tech,"None,"
09/08/2022,20220908,202209,2022.36,2022,Quest Diagnostics,Debit-Card,-252,3785,tech,"None,"
09/08/2022,20220908,202209,2022.36,2022,Omnicom Group,Debit-Card,430,4037,invest,"None,"
09/08/2022,20220908,202209,2022.36,2022,Voya Financial,Debit-Card,-996,3607,clothing,"None,"
09/07/2022,20220907,202209,2022.36,2022,Amazon.com,Debit-Card,-910,4603,tech,"None,"
09/07/2022,20220907,202209,2022.36,2022,Ulta Beauty,Debit-Card,-651,5513,grocery,"None,"
09/07/2022,20220907,202209,2022.36,2022,Ulta Beauty,Debit-Card,519,6164,health,"None,"
09/07/2022,20220907,202209,2022.36,2022,CBRE Group,Debit-Card,320,5645,unk,"None,"
09/07/2022,20220907,202209,2022.36,2022,Travelers,Debit-Card,832,5325,paypal,"None,"
09/06/2022,20220906,202209,2022.36,2022,Sysco,Debit-Card,-944,4493,grocery,"None,"
09/06/2022,20220906,202209,2022.36,2022,Ulta Beauty,Debit-Card,-536,5437,paypal,"None,"
09/06/2022,20220906,202209,2022.36,2022,Visa,Debit-Card,16,5973,unk,"None,"
09/06/2022,20220906,202209,2022.36,2022,Visa,Debit-Card,11,5957,health,"None,"
09/06/2022,20220906,202209,2022.36,2022,Sysco,Debit-Card,-873,5946,misc,"None,"
09/06/2022,20220906,202209,2022.36,2022,CBRE Group,Debit-Card,-307,6819,travel,"None,"
09/06/2022,20220906,202209,2022.36,2022,Sysco,Debit-Card,-464,7126,tech,"None,"
09/06/2022,20220906,202209,2022.36,2022,Hanesbrands,Debit-Card,-1000,7590,invest,"None,"
09/06/2022,20220906,202209,2022.36,2022,Ulta Beauty,Debit-Card,-461,8590,unk,"None,"
09/06/2022,20220906,202209,2022.36,2022,Hershey,Debit-Card,-366,9051,invest,"None,"
09/06/2022,20220906,202209,2022.36,2022,Tapestry,Debit-Card,258,9417,invest,"None,"
09/06/2022,20220906,202209,2022.36,2022,Ulta Beauty,Debit-Card,459,9159,grocery,"None,"
09/06/2022,20220906,202209,2022.36,2022,United Continental Holdings,Debit-Card,828,8700,utility,"None,"
09/06/2022,20220906,202209,2022.36,2022,Entergy,Debit-Card,913,7872,travel,"None,"
09/06/2022,20220906,202209,2022.36,2022,Sysco,Debit-Card,454,6959,invest,"None,"
09/06/2022,20220906,202209,2022.36,2022,Hanesbrands,Debit-Card,-420,6505,paypal,"None,"
09/06/2022,20220906,202209,2022.36,2022,PPL,Debit-Card,219,6925,grocery,"None,"
09/06/2022,20220906,202209,2022.36,2022,Entergy,Debit-Card,677,6706,debt,"None,"
09/06/2022,20220906,202209,2022.36,2022,Walmart,Debit-Card,-673,6029,grocery,"None,"
09/06/2022,20220906,202209,2022.36,2022,PPL,Debit-Card,-650,6702,paypal,"None,"
09/02/2022,20220902,202209,2022.35,2022,CBRE Group,Debit-Card,-38,7352,misc,"None,"
09/02/2022,20220902,202209,2022.35,2022,TIAA,Debit-Card,214,7390,health,"None,"
09/01/2022,20220901,202209,2022.35,2022,TIAA,Debit-Card,238,7176,utility,"None,"
08/31/2022,20220831,202208,2022.35,2022,Hershey,Debit-Card,46,6938,clothing,"None,"
08/31/2022,20220831,202208,2022.35,2022,Hanesbrands,Debit-Card,-141,6892,paypal,"None,"
08/31/2022,20220831,202208,2022.35,2022,Visa,Debit-Card,-951,7033,invest,"None,"
08/31/2022,20220831,202208,2022.35,2022,Walmart,Debit-Card,-954,7984,invest,"None,"
08/31/2022,20220831,202208,2022.35,2022,Hanesbrands,Debit-Card,281,8938,paypal,"None,"
08/31/2022,20220831,202208,2022.35,2022,Walmart,Debit-Card,-84,8657,invest,"None,"
08/31/2022,20220831,202208,2022.35,2022,Quest Diagnostics,Debit-Card,230,8741,tech,"None,"
08/30/2022,20220830,202208,2022.35,2022,Ulta Beauty,Debit-Card,169,8511,travel,"None,"
08/30/2022,20220830,202208,2022.35,2022,TIAA,Debit-Card,-477,8342,grocery,"None,"
08/30/2022,20220830,202208,2022.35,2022,Travelers,Debit-Card,623,8819,clothing,"None,"
08/30/2022,20220830,202208,2022.35,2022,Hanesbrands,Debit-Card,-782,8196,travel,"None,"
08/29/2022,20220829,202208,2022.35,2022,Amazon.com,Debit-Card,-267,8978,invest,"None,"
08/29/2022,20220829,202208,2022.35,2022,Omnicom Group,Debit-Card,-231,9245,debt,"None,"
08/29/2022,20220829,202208,2022.35,2022,PPL,Debit-Card,-579,9476,paypal,"None,"
08/29/2022,20220829,202208,2022.35,2022,Amazon.com,Debit-Card,-646,10055,clothing,"None,"
08/29/2022,20220829,202208,2022.35,2022,Visa,Debit-Card,-313,10701,unk,"None,"
08/29/2022,20220829,202208,2022.35,2022,Voya Financial,Debit-Card,19,11014,travel,"None,"
08/29/2022,20220829,202208,2022.35,2022,Ulta Beauty,Debit-Card,621,10995,unk,"None,"
08/29/2022,20220829,202208,2022.35,2022,Cognizant Technology Solutions,Debit-Card,436,10374,travel,"None,"
08/26/2022,20220826,202208,2022.34,2022,Amazon.com,Debit-Card,-390,9938,invest,"None,"
08/26/2022,20220826,202208,2022.34,2022,Omnicom Group,Debit-Card,110,10328,health,"None,"
08/26/2022,20220826,202208,2022.34,2022,Travelers,Debit-Card,962,10218,unk,"None,"
08/25/2022,20220825,202208,2022.34,2022,Walmart,Debit-Card,-30,9256,debt,"None,"
08/25/2022,20220825,202208,2022.34,2022,Delta Air Lines,Debit-Card,811,9286,health,"None,"
08/24/2022,20220824,202208,2022.34,2022,Hewlett Packard Enterprise,Debit-Card,-368,8475,tech,"None,"
08/24/2022,20220824,202208,2022.34,2022,Amazon.com,Debit-Card,241,8843,unk,"None,"
08/24/2022,20220824,202208,2022.34,2022,TIAA,Debit-Card,-37,8602,paypal,"None,"
08/23/2022,20220823,202208,2022.34,2022,Amazon.com,Debit-Card,-318,8639,health,"None,"
08/23/2022,20220823,202208,2022.34,2022,PPL,Debit-Card,203,8957,unk,"None,"
08/22/2022,20220822,202208,2022.34,2022,Sysco,Debit-Card,-905,8754,grocery,"None,"
08/22/2022,20220822,202208,2022.34,2022,Hewlett Packard Enterprise,Debit-Card,-168,9659,grocery,"None,"
08/22/2022,20220822,202208,2022.34,2022,Tapestry,Debit-Card,207,9827,misc,"None,"
08/22/2022,20220822,202208,2022.34,2022,Cognizant Technology Solutions,Debit-Card,147,9620,utility,"None,"
08/22/2022,20220822,202208,2022.34,2022,TIAA,Debit-Card,507,9473,invest,"None,"
08/22/2022,20220822,202208,2022.34,2022,Travelers,Debit-Card,-410,8966,tech,"None,"
08/22/2022,20220822,202208,2022.34,2022,Omnicom Group,Debit-Card,759,9376,invest,"None,"
08/22/2022,20220822,202208,2022.34,2022,Voya Financial,Debit-Card,-137,8617,invest,"None,"
08/22/2022,20220822,202208,2022.34,2022,Delta Air Lines,Debit-Card,-883,8754,grocery,"None,"
08/22/2022,20220822,202208,2022.34,2022,Visa,Debit-Card,-945,9637,grocery,"None,"
08/22/2022,20220822,202208,2022.34,2022,Amazon.com,Debit-Card,-494,10582,travel,"None,"
08/19/2022,20220819,202208,2022.33,2022,TIAA,Debit-Card,763,11076,tech,"None,"
08/19/2022,20220819,202208,2022.33,2022,Walmart,Debit-Card,141,10313,unk,"None,"
08/19/2022,20220819,202208,2022.33,2022,CBRE Group,Debit-Card,210,10172,health,"None,"
08/19/2022,20220819,202208,2022.33,2022,Entergy,Debit-Card,-657,9962,invest,"None,"
08/18/2022,20220818,202208,2022.33,2022,Voya Financial,Debit-Card,925,10619,invest,"None,"
08/18/2022,20220818,202208,2022.33,2022,TIAA,Debit-Card,897,9694,grocery,"None,"
08/18/2022,20220818,202208,2022.33,2022,Cognizant Technology Solutions,Debit-Card,-460,8797,invest,"None,"
08/18/2022,20220818,202208,2022.33,2022,Hewlett Packard Enterprise,Debit-Card,288,9257,grocery,"None,"
08/17/2022,20220817,202208,2022.33,2022,Omnicom Group,Debit-Card,-590,8969,paypal,"None,"
08/17/2022,20220817,202208,2022.33,2022,Delta Air Lines,Debit-Card,592,9559,invest,"None,"
08/17/2022,20220817,202208,2022.33,2022,Ulta Beauty,Debit-Card,-286,8967,debt,"None,"
08/16/2022,20220816,202208,2022.33,2022,Omnicom Group,Debit-Card,-813,9253,health,"None,"
08/16/2022,20220816,202208,2022.33,2022,Travelers,Debit-Card,-361,10066,invest,"None,"
08/15/2022,20220815,202208,2022.33,2022,United Continental Holdings,Debit-Card,352,10427,travel,"None,"
08/15/2022,20220815,202208,2022.33,2022,Ulta Beauty,Debit-Card,856,10075,unk,"None,"
08/15/2022,20220815,202208,2022.33,2022,Quest Diagnostics,Debit-Card,-217,9219,unk,"None,"
08/15/2022,20220815,202208,2022.33,2022,Tapestry,Debit-Card,125,9436,tech,"None,"
08/15/2022,20220815,202208,2022.33,2022,Ulta Beauty,Debit-Card,423,9311,utility,"None,"
08/15/2022,20220815,202208,2022.33,2022,Entergy,Debit-Card,99,8888,utility,"None,"
08/15/2022,20220815,202208,2022.33,2022,Visa,Debit-Card,329,8789,health,"None,"
08/15/2022,20220815,202208,2022.33,2022,Ulta Beauty,Debit-Card,-211,8460,grocery,"None,"
08/15/2022,20220815,202208,2022.33,2022,Delta Air Lines,Debit-Card,-274,8671,grocery,"None,"
08/15/2022,20220815,202208,2022.33,2022,TIAA,Debit-Card,384,8945,clothing,"None,"
08/12/2022,20220812,202208,2022.32,2022,Voya Financial,Debit-Card,640,8561,misc,"None,"
08/12/2022,20220812,202208,2022.32,2022,Amazon.com,Debit-Card,17,7921,misc,"None,"
08/11/2022,20220811,202208,2022.32,2022,Hewlett Packard Enterprise,Debit-Card,350,7904,unk,"None,"
08/11/2022,20220811,202208,2022.32,2022,Sysco,Debit-Card,109,7554,unk,"None,"
08/10/2022,20220810,202208,2022.32,2022,Omnicom Group,Debit-Card,-153,7445,misc,"None,"
08/10/2022,20220810,202208,2022.32,2022,Cognizant Technology Solutions,Debit-Card,-657,7598,debt,"None,"
08/10/2022,20220810,202208,2022.32,2022,Entergy,Debit-Card,-710,8255,travel,"None,"
08/10/2022,20220810,202208,2022.32,2022,United Continental Holdings,Debit-Card,-887,8965,misc,"None,"
08/10/2022,20220810,202208,2022.32,2022,Tapestry,Debit-Card,829,9852,tech,"None,"
08/09/2022,20220809,202208,2022.32,2022,Delta Air Lines,Debit-Card,254,9023,travel,"None,"
08/09/2022,20220809,202208,2022.32,2022,Hewlett Packard Enterprise,Debit-Card,644,8769,unk,"None,"
08/09/2022,20220809,202208,2022.32,2022,Hewlett Packard Enterprise,Debit-Card,-243,8125,tech,"None,"
08/09/2022,20220809,202208,2022.32,2022,Hewlett Packard Enterprise,Debit-Card,653,8368,invest,"None,"
08/08/2022,20220808,202208,2022.32,2022,Hanesbrands,Debit-Card,-34,7715,unk,"None,"
08/08/2022,20220808,202208,2022.32,2022,Visa,Debit-Card,-822,7749,misc,"None,"
08/08/2022,20220808,202208,2022.32,2022,Sysco,Debit-Card,-823,8571,clothing,"None,"
08/08/2022,20220808,202208,2022.32,2022,Omnicom Group,Debit-Card,969,9394,travel,"None,"
08/08/2022,20220808,202208,2022.32,2022,Hanesbrands,Debit-Card,-752,8425,invest,"None,"
08/08/2022,20220808,202208,2022.32,2022,Tapestry,Debit-Card,-179,9177,invest,"None,"
08/08/2022,20220808,202208,2022.32,2022,Cognizant Technology Solutions,Debit-Card,549,9356,tech,"None,"
08/08/2022,20220808,202208,2022.32,2022,Voya Financial,Debit-Card,-313,8807,unk,"None,"
08/08/2022,20220808,202208,2022.32,2022,Visa,Debit-Card,-626,9120,utility,"None,"
08/05/2022,20220805,202208,2022.31,2022,Tapestry,Debit-Card,-896,9746,health,"None,"
08/05/2022,20220805,202208,2022.31,2022,Hanesbrands,Debit-Card,901,10642,misc,"None,"
08/04/2022,20220804,202208,2022.31,2022,CBRE Group,Debit-Card,460,9741,invest,"None,"
08/03/2022,20220803,202208,2022.31,2022,Voya Financial,Debit-Card,430,9281,health,"None,"
08/03/2022,20220803,202208,2022.31,2022,TIAA,Debit-Card,-657,8851,invest,"None,"
08/02/2022,20220802,202208,2022.31,2022,Omnicom Group,Debit-Card,-171,9508,grocery,"None,"
08/02/2022,20220802,202208,2022.31,2022,Amazon.com,Debit-Card,-950,9679,travel,"None,"
08/02/2022,20220802,202208,2022.31,2022,Tapestry,Debit-Card,555,10629,unk,"None,"
08/02/2022,20220802,202208,2022.31,2022,Entergy,Debit-Card,620,10074,grocery,"None,"
08/02/2022,20220802,202208,2022.31,2022,Ulta Beauty,Debit-Card,771,9454,paypal,"None,"
08/01/2022,20220801,202208,2022.31,2022,CBRE Group,Debit-Card,-983,8683,clothing,"None,"
08/01/2022,20220801,202208,2022.31,2022,TIAA,Debit-Card,-484,9666,unk,"None,"
08/01/2022,20220801,202208,2022.31,2022,TIAA,Debit-Card,-940,10150,debt,"None,"
08/01/2022,20220801,202208,2022.31,2022,Sysco,Debit-Card,372,11090,misc,"None,"
08/01/2022,20220801,202208,2022.31,2022,Hewlett Packard Enterprise,Debit-Card,744,10718,misc,"None,"
08/01/2022,20220801,202208,2022.31,2022,United Continental Holdings,Debit-Card,-581,9974,tech,"None,"
08/01/2022,20220801,202208,2022.31,2022,Hershey,Debit-Card,931,10555,misc,"None,"
08/01/2022,20220801,202208,2022.31,2022,Delta Air Lines,Debit-Card,-480,9624,travel,"None,"
08/01/2022,20220801,202208,2022.31,2022,Travelers,Debit-Card,-167,10104,invest,"None,"
08/01/2022,20220801,202208,2022.31,2022,Hershey,Debit-Card,91,10271,unk,"None,"
07/29/2022,20220729,202207,2022.3,2022,Amazon.com,Debit-Card,-825,10180,tech,"None,"
07/29/2022,20220729,202207,2022.3,2022,Voya Financial,Debit-Card,-363,11005,travel,"None,"
07/29/2022,20220729,202207,2022.3,2022,Ulta Beauty,Debit-Card,-727,11368,paypal,"None,"
07/29/2022,20220729,202207,2022.3,2022,Tapestry,Debit-Card,39,12095,travel,"None,"
07/29/2022,20220729,202207,2022.3,2022,Entergy,Debit-Card,829,12056,misc,"None,"
07/29/2022,20220729,202207,2022.3,2022,Sysco,Debit-Card,889,11227,utility,"None,"
07/29/2022,20220729,202207,2022.3,2022,Entergy,Debit-Card,-33,10338,utility,"None,"
07/28/2022,20220728,202207,2022.3,2022,Walmart,Debit-Card,-199,10371,travel,"None,"
07/28/2022,20220728,202207,2022.3,2022,Hanesbrands,Debit-Card,-90,10570,grocery,"None,"
07/27/2022,20220727,202207,2022.3,2022,TIAA,Debit-Card,-202,10660,clothing,"None,"
07/27/2022,20220727,202207,2022.3,2022,United Continental Holdings,Debit-Card,618,10862,unk,"None,"
07/27/2022,20220727,202207,2022.3,2022,Travelers,Debit-Card,319,10244,clothing,"None,"
07/26/2022,20220726,202207,2022.3,2022,Sysco,Debit-Card,-365,9925,debt,"None,"
07/26/2022,20220726,202207,2022.3,2022,Sysco,Debit-Card,-497,10290,misc,"None,"
07/25/2022,20220725,202207,2022.3,2022,Delta Air Lines,Debit-Card,50,10787,grocery,"None,"
07/25/2022,20220725,202207,2022.3,2022,TIAA,Debit-Card,358,10737,misc,"None,"
07/25/2022,20220725,202207,2022.3,2022,Hewlett Packard Enterprise,Debit-Card,594,10379,invest,"None,"
07/25/2022,20220725,202207,2022.3,2022,United Continental Holdings,Debit-Card,690,9785,invest,"None,"
07/25/2022,20220725,202207,2022.3,2022,Delta Air Lines,Debit-Card,-605,9095,health,"None,"
07/22/2022,20220722,202207,2022.29,2022,Travelers,Debit-Card,-409,9700,health,"None,"
07/22/2022,20220722,202207,2022.29,2022,Hewlett Packard Enterprise,Debit-Card,-409,10109,health,"None,"
07/22/2022,20220722,202207,2022.29,2022,Quest Diagnostics,Debit-Card,518,10518,unk,"None,"
07/22/2022,20220722,202207,2022.29,2022,TIAA,Debit-Card,-609,10000,clothing,"None,"
07/21/2022,20220721,202207,2022.29,2022,Voya Financial,Debit-Card,184,10609,grocery,"None,"
07/21/2022,20220721,202207,2022.29,2022,TIAA,Debit-Card,83,10425,tech,"None,"
07/20/2022,20220720,202207,2022.29,2022,Amazon.com,Debit-Card,981,10342,utility,"None,"
07/19/2022,20220719,202207,2022.29,2022,Hershey,Debit-Card,-538,9361,invest,"None,"
07/19/2022,20220719,202207,2022.29,2022,Hanesbrands,Debit-Card,286,9899,grocery,"None,"
07/19/2022,20220719,202207,2022.29,2022,CBRE Group,Debit-Card,-314,9613,travel,"None,"
07/19/2022,20220719,202207,2022.29,2022,Sysco,Debit-Card,693,9927,invest,"None,"
07/19/2022,20220719,202207,2022.29,2022,CBRE Group,Debit-Card,184,9234,misc,"None,"
07/18/2022,20220718,202207,2022.29,2022,Cognizant Technology Solutions,Debit-Card,845,9050,misc,"None,"
07/18/2022,20220718,202207,2022.29,2022,Ulta Beauty,Debit-Card,993,8205,invest,"None,"
07/18/2022,20220718,202207,2022.29,2022,Quest Diagnostics,Debit-Card,453,7212,paypal,"None,"
07/18/2022,20220718,202207,2022.29,2022,Walmart,Debit-Card,26,6759,grocery,"None,"
07/18/2022,20220718,202207,2022.29,2022,Cognizant Technology Solutions,Debit-Card,-880,6733,health,"None,"
07/18/2022,20220718,202207,2022.29,2022,CBRE Group,Debit-Card,-420,7613,debt,"None,"
07/18/2022,20220718,202207,2022.29,2022,Voya Financial,Debit-Card,740,8033,misc,"None,"
07/18/2022,20220718,202207,2022.29,2022,Amazon.com,Debit-Card,278,7293,paypal,"None,"
07/18/2022,20220718,202207,2022.29,2022,Ulta Beauty,Debit-Card,-674,7015,health,"None,"
07/18/2022,20220718,202207,2022.29,2022,Hewlett Packard Enterprise,Debit-Card,832,7689,health,"None,"
07/18/2022,20220718,202207,2022.29,2022,CBRE Group,Debit-Card,-843,6857,health,"None,"
07/15/2022,20220715,202207,2022.28,2022,United Continental Holdings,Debit-Card,-652,7700,utility,"None,"
07/15/2022,20220715,202207,2022.28,2022,United Continental Holdings,Debit-Card,861,8352,misc,"None,"
07/15/2022,20220715,202207,2022.28,2022,PPL,Debit-Card,370,7491,grocery,"None,"
07/15/2022,20220715,202207,2022.28,2022,Delta Air Lines,Debit-Card,73,7121,clothing,"None,"
07/15/2022,20220715,202207,2022.28,2022,Visa,Debit-Card,-728,7048,utility,"None,"
07/14/2022,20220714,202207,2022.28,2022,Walmart,Debit-Card,265,7776,unk,"None,"
07/14/2022,20220714,202207,2022.28,2022,Travelers,Debit-Card,832,7511,unk,"None,"
07/13/2022,20220713,202207,2022.28,2022,PPL,Debit-Card,38,6679,paypal,"None,"
07/13/2022,20220713,202207,2022.28,2022,Ulta Beauty,Debit-Card,824,6641,misc,"None,"
07/12/2022,20220712,202207,2022.28,2022,Hewlett Packard Enterprise,Debit-Card,312,5817,health,"None,"
07/12/2022,20220712,202207,2022.28,2022,Amazon.com,Debit-Card,847,5505,health,"None,"
07/11/2022,20220711,202207,2022.28,2022,TIAA,Debit-Card,-339,4658,tech,"None,"
07/11/2022,20220711,202207,2022.28,2022,Cognizant Technology Solutions,Debit-Card,-711,4997,clothing,"None,"
07/11/2022,20220711,202207,2022.28,2022,Ulta Beauty,Debit-Card,-832,5708,clothing,"None,"
07/11/2022,20220711,202207,2022.28,2022,Hewlett Packard Enterprise,Debit-Card,450,6540,tech,"None,"
07/11/2022,20220711,202207,2022.28,2022,Walmart,Debit-Card,86,6090,debt,"None,"
07/11/2022,20220711,202207,2022.28,2022,TIAA,Debit-Card,-68,6004,invest,"None,"
07/11/2022,20220711,202207,2022.28,2022,Hewlett Packard Enterprise,Debit-Card,-911,6072,invest,"None,"
07/08/2022,20220708,202207,2022.27,2022,Cognizant Technology Solutions,Debit-Card,816,6983,clothing,"None,"
07/08/2022,20220708,202207,2022.27,2022,Travelers,Debit-Card,-63,6167,grocery,"None,"
07/08/2022,20220708,202207,2022.27,2022,Cognizant Technology Solutions,Debit-Card,-830,6230,misc,"None,"
07/08/2022,20220708,202207,2022.27,2022,Sysco,Debit-Card,-241,7060,unk,"None,"
07/08/2022,20220708,202207,2022.27,2022,PPL,Debit-Card,-91,7301,misc,"None,"
07/05/2022,20220705,202207,2022.27,2022,CBRE Group,Debit-Card,229,7392,travel,"None,"
07/05/2022,20220705,202207,2022.27,2022,Cognizant Technology Solutions,Debit-Card,-420,7163,travel,"None,"
07/05/2022,20220705,202207,2022.27,2022,Ulta Beauty,Debit-Card,515,7583,travel,"None,"
07/05/2022,20220705,202207,2022.27,2022,CBRE Group,Debit-Card,570,7068,health,"None,"
07/05/2022,20220705,202207,2022.27,2022,Cognizant Technology Solutions,Debit-Card,375,6498,utility,"None,"
07/05/2022,20220705,202207,2022.27,2022,Hershey,Debit-Card,-552,6123,travel,"None,"
07/05/2022,20220705,202207,2022.27,2022,Tapestry,Debit-Card,880,6675,grocery,"None,"
07/05/2022,20220705,202207,2022.27,2022,United Continental Holdings,Debit-Card,-125,5795,tech,"None,"
07/01/2022,20220701,202207,2022.26,2022,Visa,Debit-Card,-353,5920,misc,"None,"
07/01/2022,20220701,202207,2022.26,2022,Entergy,Debit-Card,438,6273,unk,"None,"
07/01/2022,20220701,202207,2022.26,2022,Travelers,Debit-Card,264,5835,travel,"None,"
06/30/2022,20220630,202206,2022.26,2022,Amazon.com,Debit-Card,948,5571,travel,"None,"
06/30/2022,20220630,202206,2022.26,2022,Delta Air Lines,Debit-Card,53,4623,tech,"None,"
06/30/2022,20220630,202206,2022.26,2022,Visa,Debit-Card,676,4570,travel,"None,"
06/29/2022,20220629,202206,2022.26,2022,Ulta Beauty,Debit-Card,-775,3894,travel,"None,"
06/29/2022,20220629,202206,2022.26,2022,Delta Air Lines,Debit-Card,-817,4669,invest,"None,"
06/28/2022,20220628,202206,2022.26,2022,Tapestry,Debit-Card,487,5486,travel,"None,"
06/28/2022,20220628,202206,2022.26,2022,Voya Financial,Debit-Card,-634,4999,tech,"None,"
06/28/2022,20220628,202206,2022.26,2022,United Continental Holdings,Debit-Card,-238,5633,invest,"None,"
06/27/2022,20220627,202206,2022.26,2022,CBRE Group,Debit-Card,-947,5871,unk,"None,"
06/27/2022,20220627,202206,2022.26,2022,Sysco,Debit-Card,455,6818,travel,"None,"
06/27/2022,20220627,202206,2022.26,2022,Hershey,Debit-Card,-836,6363,health,"None,"
06/27/2022,20220627,202206,2022.26,2022,United Continental Holdings,Debit-Card,498,7199,invest,"None,"
06/27/2022,20220627,202206,2022.26,2022,PPL,Debit-Card,-227,6701,health,"None,"
06/27/2022,20220627,202206,2022.26,2022,Entergy,Debit-Card,-895,6928,utility,"None,"
06/27/2022,20220627,202206,2022.26,2022,Hanesbrands,Debit-Card,324,7823,paypal,"None,"
06/27/2022,20220627,202206,2022.26,2022,Quest Diagnostics,Debit-Card,-995,7499,unk,"None,"
06/27/2022,20220627,202206,2022.26,2022,PPL,Debit-Card,-902,8494,grocery,"None,"
06/24/2022,20220624,202206,2022.25,2022,Amazon.com,Debit-Card,813,9396,health,"None,"
06/24/2022,20220624,202206,2022.25,2022,Walmart,Debit-Card,-426,8583,unk,"None,"
06/23/2022,20220623,202206,2022.25,2022,Ulta Beauty,Debit-Card,875,9009,invest,"None,"
06/23/2022,20220623,202206,2022.25,2022,Tapestry,Debit-Card,550,8134,grocery,"None,"
06/22/2022,20220622,202206,2022.25,2022,Travelers,Debit-Card,381,7584,tech,"None,"
06/22/2022,20220622,202206,2022.25,2022,Travelers,Debit-Card,224,7203,tech,"None,"
06/22/2022,20220622,202206,2022.25,2022,Hewlett Packard Enterprise,Debit-Card,326,6979,health,"None,"
06/22/2022,20220622,202206,2022.25,2022,CBRE Group,Debit-Card,547,6653,health,"None,"
06/21/2022,20220621,202206,2022.25,2022,PPL,Debit-Card,50,6106,invest,"None,"
06/21/2022,20220621,202206,2022.25,2022,Walmart,Debit-Card,-675,6056,invest,"None,"
06/21/2022,20220621,202206,2022.25,2022,Tapestry,Debit-Card,923,6731,debt,"None,"
06/21/2022,20220621,202206,2022.25,2022,Entergy,Debit-Card,-271,5808,paypal,"None,"
06/21/2022,20220621,202206,2022.25,2022,Hanesbrands,Debit-Card,929,6079,unk,"None,"
06/21/2022,20220621,202206,2022.25,2022,Cognizant Technology Solutions,Debit-Card,-500,5150,debt,"None,"
06/21/2022,20220621,202206,2022.25,2022,PPL,Debit-Card,-73,5650,tech,"None,"
06/21/2022,20220621,202206,2022.25,2022,Visa,Debit-Card,-360,5723,grocery,"None,"
06/21/2022,20220621,202206,2022.25,2022,Cognizant Technology Solutions,Debit-Card,740,6083,grocery,"None,"
06/21/2022,20220621,202206,2022.25,2022,Visa,Debit-Card,-669,5343,invest,"None,"
06/21/2022,20220621,202206,2022.25,2022,Hewlett Packard Enterprise,Debit-Card,-998,6012,travel,"None,"
06/21/2022,20220621,202206,2022.25,2022,Voya Financial,Debit-Card,278,7010,invest,"None,"
06/17/2022,20220617,202206,2022.24,2022,United Continental Holdings,Debit-Card,-301,6732,travel,"None,"
06/17/2022,20220617,202206,2022.24,2022,Sysco,Debit-Card,-518,7033,invest,"None,"
06/17/2022,20220617,202206,2022.24,2022,TIAA,Debit-Card,467,7551,misc,"None,"
06/17/2022,20220617,202206,2022.24,2022,Hanesbrands,Debit-Card,-510,7084,debt,"None,"
06/16/2022,20220616,202206,2022.24,2022,Voya Financial,Debit-Card,-584,7594,tech,"None,"
06/16/2022,20220616,202206,2022.24,2022,Delta Air Lines,Debit-Card,271,8178,travel,"None,"
06/16/2022,20220616,202206,2022.24,2022,Hewlett Packard Enterprise,Debit-Card,250,7907,unk,"None,"
06/16/2022,20220616,202206,2022.24,2022,Hershey,Debit-Card,115,7657,debt,"None,"
06/16/2022,20220616,202206,2022.24,2022,Voya Financial,Debit-Card,508,7542,health,"None,"
06/15/2022,20220615,202206,2022.24,2022,Voya Financial,Debit-Card,-847,7034,travel,"None,"
06/15/2022,20220615,202206,2022.24,2022,Amazon.com,Debit-Card,-80,7881,unk,"None,"
06/14/2022,20220614,202206,2022.24,2022,Quest Diagnostics,Debit-Card,-634,7961,invest,"None,"
06/14/2022,20220614,202206,2022.24,2022,Ulta Beauty,Debit-Card,573,8595,invest,"None,"
06/13/2022,20220613,202206,2022.24,2022,Omnicom Group,Debit-Card,-471,8022,debt,"None,"
06/13/2022,20220613,202206,2022.24,2022,Sysco,Debit-Card,-666,8493,invest,"None,"
06/13/2022,20220613,202206,2022.24,2022,CBRE Group,Debit-Card,843,9159,tech,"None,"
06/13/2022,20220613,202206,2022.24,2022,CBRE Group,Debit-Card,-622,8316,unk,"None,"
06/13/2022,20220613,202206,2022.24,2022,Hanesbrands,Debit-Card,-86,8938,tech,"None,"
06/13/2022,20220613,202206,2022.24,2022,Hershey,Debit-Card,-220,9024,tech,"None,"
06/10/2022,20220610,202206,2022.23,2022,Sysco,Debit-Card,-660,9244,unk,"None,"
06/10/2022,20220610,202206,2022.23,2022,United Continental Holdings,Debit-Card,-333,9904,grocery,"None,"
06/09/2022,20220609,202206,2022.23,2022,Entergy,Debit-Card,-348,10237,misc,"None,"
06/09/2022,20220609,202206,2022.23,2022,Visa,Debit-Card,807,10585,utility,"None,"
06/08/2022,20220608,202206,2022.23,2022,United Continental Holdings,Debit-Card,-886,9778,unk,"None,"
06/07/2022,20220607,202206,2022.23,2022,Quest Diagnostics,Debit-Card,795,10664,misc,"None,"
06/07/2022,20220607,202206,2022.23,2022,TIAA,Debit-Card,232,9869,debt,"None,"
06/06/2022,20220606,202206,2022.23,2022,Ulta Beauty,Debit-Card,-776,9637,unk,"None,"
06/06/2022,20220606,202206,2022.23,2022,Omnicom Group,Debit-Card,-471,10413,travel,"None,"
06/06/2022,20220606,202206,2022.23,2022,Travelers,Debit-Card,-644,10884,misc,"None,"
06/06/2022,20220606,202206,2022.23,2022,Hanesbrands,Debit-Card,-895,11528,misc,"None,"
06/06/2022,20220606,202206,2022.23,2022,Hewlett Packard Enterprise,Debit-Card,-211,12423,tech,"None,"
06/06/2022,20220606,202206,2022.23,2022,Ulta Beauty,Debit-Card,-36,12634,travel,"None,"
06/06/2022,20220606,202206,2022.23,2022,Walmart,Debit-Card,934,12670,invest,"None,"
06/06/2022,20220606,202206,2022.23,2022,TIAA,Debit-Card,-403,11736,health,"None,"
06/06/2022,20220606,202206,2022.23,2022,Omnicom Group,Debit-Card,635,12139,invest,"None,"
06/06/2022,20220606,202206,2022.23,2022,TIAA,Debit-Card,-144,11504,misc,"None,"
06/03/2022,20220603,202206,2022.22,2022,Travelers,Debit-Card,42,11648,misc,"None,"
06/03/2022,20220603,202206,2022.22,2022,Ulta Beauty,Debit-Card,668,11606,invest,"None,"
06/02/2022,20220602,202206,2022.22,2022,Voya Financial,Debit-Card,522,10938,health,"None,"
06/02/2022,20220602,202206,2022.22,2022,CBRE Group,Debit-Card,284,10416,grocery,"None,"
06/02/2022,20220602,202206,2022.22,2022,Visa,Debit-Card,-825,10132,health,"None,"
06/02/2022,20220602,202206,2022.22,2022,Hanesbrands,Debit-Card,617,10957,debt,"None,"
06/01/2022,20220601,202206,2022.22,2022,Hewlett Packard Enterprise,Debit-Card,142,10340,debt,"None,"
06/01/2022,20220601,202206,2022.22,2022,Cognizant Technology Solutions,Debit-Card,206,10198,clothing,"None,"
06/01/2022,20220601,202206,2022.22,2022,Travelers,Debit-Card,-345,9992,clothing,"None,"
05/31/2022,20220531,202205,2022.22,2022,Quest Diagnostics,Debit-Card,726,10337,grocery,"None,"
05/31/2022,20220531,202205,2022.22,2022,Walmart,Debit-Card,326,9611,clothing,"None,"
05/31/2022,20220531,202205,2022.22,2022,Walmart,Debit-Card,121,9285,misc,"None,"
05/31/2022,20220531,202205,2022.22,2022,TIAA,Debit-Card,725,9164,misc,"None,"
05/31/2022,20220531,202205,2022.22,2022,Hershey,Debit-Card,837,8439,clothing,"None,"
05/31/2022,20220531,202205,2022.22,2022,PPL,Debit-Card,264,7602,grocery,"None,"
05/31/2022,20220531,202205,2022.22,2022,Cognizant Technology Solutions,Debit-Card,-198,7338,paypal,"None,"
05/27/2022,20220527,202205,2022.21,2022,Walmart,Debit-Card,-986,7536,paypal,"None,"
05/27/2022,20220527,202205,2022.21,2022,United Continental Holdings,Debit-Card,-521,8522,unk,"None,"
05/27/2022,20220527,202205,2022.21,2022,Visa,Debit-Card,-980,9043,tech,"None,"
05/27/2022,20220527,202205,2022.21,2022,United Continental Holdings,Debit-Card,-282,10023,tech,"None,"
05/26/2022,20220526,202205,2022.21,2022,Sysco,Debit-Card,-575,10305,invest,"None,"
05/26/2022,20220526,202205,2022.21,2022,Amazon.com,Debit-Card,986,10880,debt,"None,"
05/25/2022,20220525,202205,2022.21,2022,Quest Diagnostics,Debit-Card,957,9894,tech,"None,"
05/24/2022,20220524,202205,2022.21,2022,Hanesbrands,Debit-Card,-845,8937,travel,"None,"
05/23/2022,20220523,202205,2022.21,2022,United Continental Holdings,Debit-Card,-384,9782,invest,"None,"
05/23/2022,20220523,202205,2022.21,2022,Voya Financial,Debit-Card,-97,10166,health,"None,"
05/23/2022,20220523,202205,2022.21,2022,CBRE Group,Debit-Card,-266,10263,paypal,"None,"
05/23/2022,20220523,202205,2022.21,2022,Quest Diagnostics,Debit-Card,322,10529,paypal,"None,"
05/23/2022,20220523,202205,2022.21,2022,Hanesbrands,Debit-Card,-172,10207,unk,"None,"
05/23/2022,20220523,202205,2022.21,2022,Travelers,Debit-Card,-89,10379,grocery,"None,"
05/23/2022,20220523,202205,2022.21,2022,United Continental Holdings,Debit-Card,704,10468,tech,"None,"
05/23/2022,20220523,202205,2022.21,2022,Entergy,Debit-Card,284,9764,invest,"None,"
05/23/2022,20220523,202205,2022.21,2022,United Continental Holdings,Debit-Card,-949,9480,health,"None,"
05/20/2022,20220520,202205,2022.2,2022,Travelers,Debit-Card,202,10429,grocery,"None,"
05/20/2022,20220520,202205,2022.2,2022,Sysco,Debit-Card,804,10227,grocery,"None,"
05/20/2022,20220520,202205,2022.2,2022,Walmart,Debit-Card,998,9423,unk,"None,"
05/19/2022,20220519,202205,2022.2,2022,Visa,Debit-Card,11,8425,unk,"None,"
05/19/2022,20220519,202205,2022.2,2022,Omnicom Group,Debit-Card,16,8414,tech,"None,"
05/18/2022,20220518,202205,2022.2,2022,Hanesbrands,Debit-Card,433,8398,health,"None,"
05/18/2022,20220518,202205,2022.2,2022,Visa,Debit-Card,-241,7965,travel,"None,"
05/18/2022,20220518,202205,2022.2,2022,Visa,Debit-Card,-883,8206,travel,"None,"
05/17/2022,20220517,202205,2022.2,2022,PPL,Debit-Card,-880,9089,unk,"None,"
05/17/2022,20220517,202205,2022.2,2022,Hanesbrands,Debit-Card,-778,9969,debt,"None,"
05/16/2022,20220516,202205,2022.2,2022,Omnicom Group,Debit-Card,870,10747,unk,"None,"
05/16/2022,20220516,202205,2022.2,2022,Sysco,Debit-Card,-548,9877,tech,"None,"
05/16/2022,20220516,202205,2022.2,2022,Sysco,Debit-Card,-269,10425,tech,"None,"
05/16/2022,20220516,202205,2022.2,2022,Sysco,Debit-Card,-850,10694,invest,"None,"
05/16/2022,20220516,202205,2022.2,2022,Omnicom Group,Debit-Card,485,11544,utility,"None,"
05/16/2022,20220516,202205,2022.2,2022,Sysco,Debit-Card,-984,11059,unk,"None,"
05/16/2022,20220516,202205,2022.2,2022,Cognizant Technology Solutions,Debit-Card,627,12043,invest,"None,"
05/13/2022,20220513,202205,2022.19,2022,Entergy,Debit-Card,-750,11416,debt,"None,"
05/13/2022,20220513,202205,2022.19,2022,Walmart,Debit-Card,-736,12166,unk,"None,"
05/12/2022,20220512,202205,2022.19,2022,CBRE Group,Debit-Card,887,12902,debt,"None,"
05/11/2022,20220511,202205,2022.19,2022,Visa,Debit-Card,938,12015,health,"None,"
05/11/2022,20220511,202205,2022.19,2022,Cognizant Technology Solutions,Debit-Card,-12,11077,travel,"None,"
05/11/2022,20220511,202205,2022.19,2022,Tapestry,Debit-Card,650,11089,unk,"None,"
05/10/2022,20220510,202205,2022.19,2022,Sysco,Debit-Card,596,10439,grocery,"None,"
05/10/2022,20220510,202205,2022.19,2022,TIAA,Debit-Card,616,9843,clothing,"None,"
05/09/2022,20220509,202205,2022.19,2022,Travelers,Debit-Card,12,9227,utility,"None,"
05/09/2022,20220509,202205,2022.19,2022,Tapestry,Debit-Card,-210,9215,health,"None,"
05/09/2022,20220509,202205,2022.19,2022,CBRE Group,Debit-Card,380,9425,unk,"None,"
05/09/2022,20220509,202205,2022.19,2022,Tapestry,Debit-Card,-965,9045,utility,"None,"
05/09/2022,20220509,202205,2022.19,2022,Visa,Debit-Card,-934,10010,health,"None,"
05/09/2022,20220509,202205,2022.19,2022,Omnicom Group,Debit-Card,377,10944,paypal,"None,"
05/09/2022,20220509,202205,2022.19,2022,Cognizant Technology Solutions,Debit-Card,-353,10567,travel,"None,"
05/09/2022,20220509,202205,2022.19,2022,Tapestry,Debit-Card,-769,10920,unk,"None,"
05/09/2022,20220509,202205,2022.19,2022,United Continental Holdings,Debit-Card,-529,11689,misc,"None,"
05/09/2022,20220509,202205,2022.19,2022,CBRE Group,Debit-Card,-690,12218,travel,"None,"
05/09/2022,20220509,202205,2022.19,2022,United Continental Holdings,Debit-Card,-910,12908,misc,"None,"
05/09/2022,20220509,202205,2022.19,2022,Ulta Beauty,Debit-Card,557,13818,grocery,"None,"
05/06/2022,20220506,202205,2022.18,2022,TIAA,Debit-Card,589,13261,paypal,"None,"
05/06/2022,20220506,202205,2022.18,2022,Ulta Beauty,Debit-Card,-795,12672,unk,"None,"
05/05/2022,20220505,202205,2022.18,2022,Entergy,Debit-Card,28,13467,misc,"None,"
05/05/2022,20220505,202205,2022.18,2022,Tapestry,Debit-Card,-13,13439,utility,"None,"
05/03/2022,20220503,202205,2022.18,2022,Hanesbrands,Debit-Card,822,13452,health,"None,"
05/03/2022,20220503,202205,2022.18,2022,Cognizant Technology Solutions,Debit-Card,-632,12630,utility,"None,"
05/03/2022,20220503,202205,2022.18,2022,Entergy,Debit-Card,-814,13262,clothing,"None,"
05/02/2022,20220502,202205,2022.18,2022,TIAA,Debit-Card,636,14076,health,"None,"
05/02/2022,20220502,202205,2022.18,2022,TIAA,Debit-Card,-851,13440,tech,"None,"
05/02/2022,20220502,202205,2022.18,2022,Hershey,Debit-Card,-691,14291,clothing,"None,"
05/02/2022,20220502,202205,2022.18,2022,Entergy,Debit-Card,-999,14982,invest,"None,"
05/02/2022,20220502,202205,2022.18,2022,PPL,Debit-Card,-59,15981,grocery,"None,"
05/02/2022,20220502,202205,2022.18,2022,Visa,Debit-Card,-376,16040,utility,"None,"
05/02/2022,20220502,202205,2022.18,2022,Voya Financial,Debit-Card,364,16416,paypal,"None,"
05/02/2022,20220502,202205,2022.18,2022,Travelers,Debit-Card,-304,16052,debt,"None,"
05/02/2022,20220502,202205,2022.18,2022,PPL,Debit-Card,305,16356,grocery,"None,"
05/02/2022,20220502,202205,2022.18,2022,Travelers,Debit-Card,100,16051,misc,"None,"
05/02/2022,20220502,202205,2022.18,2022,Tapestry,Debit-Card,304,15951,health,"None,"
04/29/2022,20220429,202204,2022.17,2022,Delta Air Lines,Debit-Card,205,15647,paypal,"None,"
04/29/2022,20220429,202204,2022.17,2022,Travelers,Debit-Card,380,15442,grocery,"None,"
04/29/2022,20220429,202204,2022.17,2022,Amazon.com,Debit-Card,-75,15062,grocery,"None,"
04/29/2022,20220429,202204,2022.17,2022,Omnicom Group,Debit-Card,480,15137,grocery,"None,"
04/29/2022,20220429,202204,2022.17,2022,Amazon.com,Debit-Card,-981,14657,health,"None,"
04/29/2022,20220429,202204,2022.17,2022,United Continental Holdings,Debit-Card,609,15638,unk,"None,"
04/29/2022,20220429,202204,2022.17,2022,Voya Financial,Debit-Card,551,15029,misc,"None,"
04/29/2022,20220429,202204,2022.17,2022,Ulta Beauty,Debit-Card,384,14478,misc,"None,"
04/29/2022,20220429,202204,2022.17,2022,Ulta Beauty,Debit-Card,751,14094,health,"None,"
04/29/2022,20220429,202204,2022.17,2022,Voya Financial,Debit-Card,12,13343,grocery,"None,"
04/29/2022,20220429,202204,2022.17,2022,Cognizant Technology Solutions,Debit-Card,-110,13331,travel,"None,"
04/29/2022,20220429,202204,2022.17,2022,Sysco,Debit-Card,-821,13441,invest,"None,"
04/28/2022,20220428,202204,2022.17,2022,Sysco,Debit-Card,-222,14262,travel,"None,"
04/28/2022,20220428,202204,2022.17,2022,Delta Air Lines,Debit-Card,-453,14484,health,"None,"
04/28/2022,20220428,202204,2022.17,2022,Voya Financial,Debit-Card,616,14937,unk,"None,"
04/28/2022,20220428,202204,2022.17,2022,Hershey,Debit-Card,-987,14321,unk,"None,"
04/28/2022,20220428,202204,2022.17,2022,Hershey,Debit-Card,-415,15308,unk,"None,"
04/28/2022,20220428,202204,2022.17,2022,TIAA,Debit-Card,-990,15723,tech,"None,"
04/28/2022,20220428,202204,2022.17,2022,Tapestry,Debit-Card,-265,16713,invest,"None,"
04/28/2022,20220428,202204,2022.17,2022,United Continental Holdings,Debit-Card,-919,16978,unk,"None,"
04/28/2022,20220428,202204,2022.17,2022,Omnicom Group,Debit-Card,-870,17897,clothing,"None,"
04/28/2022,20220428,202204,2022.17,2022,Delta Air Lines,Debit-Card,68,18767,unk,"None,"
04/27/2022,20220427,202204,2022.17,2022,Hershey,Debit-Card,-63,18699,debt,"None,"
04/27/2022,20220427,202204,2022.17,2022,Amazon.com,Debit-Card,68,18762,paypal,"None,"
04/27/2022,20220427,202204,2022.17,2022,Travelers,Debit-Card,-264,18694,misc,"None,"
04/27/2022,20220427,202204,2022.17,2022,Voya Financial,Debit-Card,-42,18958,health,"None,"
04/27/2022,20220427,202204,2022.17,2022,Quest Diagnostics,Debit-Card,830,19000,debt,"None,"
04/27/2022,20220427,202204,2022.17,2022,Entergy,Debit-Card,-980,18170,travel,"None,"
04/27/2022,20220427,202204,2022.17,2022,Voya Financial,Debit-Card,664,19150,grocery,"None,"
04/26/2022,20220426,202204,2022.17,2022,United Continental Holdings,Debit-Card,669,18486,debt,"None,"
04/26/2022,20220426,202204,2022.17,2022,Voya Financial,Debit-Card,663,17817,misc,"None,"
04/26/2022,20220426,202204,2022.17,2022,Hewlett Packard Enterprise,Debit-Card,117,17154,misc,"None,"
04/26/2022,20220426,202204,2022.17,2022,Quest Diagnostics,Debit-Card,818,17037,unk,"None,"
04/25/2022,20220425,202204,2022.17,2022,Quest Diagnostics,Debit-Card,520,16219,misc,"None,"
04/25/2022,20220425,202204,2022.17,2022,Ulta Beauty,Debit-Card,-267,15699,utility,"None,"
04/25/2022,20220425,202204,2022.17,2022,CBRE Group,Debit-Card,-293,15966,debt,"None,"
04/25/2022,20220425,202204,2022.17,2022,Cognizant Technology Solutions,Debit-Card,-36,16259,clothing,"None,"
04/25/2022,20220425,202204,2022.17,2022,Ulta Beauty,Debit-Card,-809,16295,tech,"None,"
04/25/2022,20220425,202204,2022.17,2022,Travelers,Debit-Card,253,17104,invest,"None,"
04/25/2022,20220425,202204,2022.17,2022,Travelers,Debit-Card,347,16851,tech,"None,"
04/25/2022,20220425,202204,2022.17,2022,Tapestry,Debit-Card,227,16504,health,"None,"
04/25/2022,20220425,202204,2022.17,2022,Amazon.com,Debit-Card,834,16277,invest,"None,"
04/25/2022,20220425,202204,2022.17,2022,Voya Financial,Debit-Card,694,15443,clothing,"None,"
04/22/2022,20220422,202204,2022.16,2022,Travelers,Debit-Card,-604,14749,unk,"None,"
04/22/2022,20220422,202204,2022.16,2022,Visa,Debit-Card,-793,15353,paypal,"None,"
04/22/2022,20220422,202204,2022.16,2022,Entergy,Debit-Card,412,16146,misc,"None,"
04/21/2022,20220421,202204,2022.16,2022,Quest Diagnostics,Debit-Card,605,15734,unk,"None,"
04/21/2022,20220421,202204,2022.16,2022,Entergy,Debit-Card,309,15129,clothing,"None,"
04/21/2022,20220421,202204,2022.16,2022,Hershey,Debit-Card,548,14820,paypal,"None,"
04/20/2022,20220420,202204,2022.16,2022,Quest Diagnostics,Debit-Card,-296,14272,misc,"None,"
04/20/2022,20220420,202204,2022.16,2022,PPL,Debit-Card,469,14568,invest,"None,"
04/20/2022,20220420,202204,2022.16,2022,Ulta Beauty,Debit-Card,381,14099,travel,"None,"
04/19/2022,20220419,202204,2022.16,2022,Tapestry,Debit-Card,-638,13718,debt,"None,"
04/19/2022,20220419,202204,2022.16,2022,Hershey,Debit-Card,211,14356,utility,"None,"
04/19/2022,20220419,202204,2022.16,2022,Hanesbrands,Debit-Card,385,14145,travel,"None,"
04/19/2022,20220419,202204,2022.16,2022,Travelers,Debit-Card,-881,13760,grocery,"None,"
04/19/2022,20220419,202204,2022.16,2022,PPL,Debit-Card,620,14641,travel,"None,"
04/18/2022,20220418,202204,2022.16,2022,Omnicom Group,Debit-Card,378,14021,utility,"None,"
04/18/2022,20220418,202204,2022.16,2022,Voya Financial,Debit-Card,415,13643,invest,"None,"
04/18/2022,20220418,202204,2022.16,2022,Hershey,Debit-Card,-356,13228,tech,"None,"
04/18/2022,20220418,202204,2022.16,2022,Hershey,Debit-Card,693,13584,grocery,"None,"
04/15/2022,20220415,202204,2022.15,2022,Travelers,Debit-Card,288,12891,grocery,"None,"
04/15/2022,20220415,202204,2022.15,2022,Quest Diagnostics,Debit-Card,-413,12603,paypal,"None,"
04/15/2022,20220415,202204,2022.15,2022,Omnicom Group,Debit-Card,478,13016,utility,"None,"
04/14/2022,20220414,202204,2022.15,2022,CBRE Group,Debit-Card,-332,12538,misc,"None,"
04/14/2022,20220414,202204,2022.15,2022,Quest Diagnostics,Debit-Card,589,12870,misc,"None,"
04/14/2022,20220414,202204,2022.15,2022,Amazon.com,Debit-Card,272,12281,debt,"None,"
04/14/2022,20220414,202204,2022.15,2022,Visa,Debit-Card,-437,12009,invest,"None,"
04/13/2022,20220413,202204,2022.15,2022,Quest Diagnostics,Debit-Card,919,12446,travel,"None,"
04/12/2022,20220412,202204,2022.15,2022,Sysco,Debit-Card,650,11527,invest,"None,"
04/12/2022,20220412,202204,2022.15,2022,Hanesbrands,Debit-Card,887,10877,unk,"None,"
04/12/2022,20220412,202204,2022.15,2022,TIAA,Debit-Card,-687,9990,misc,"None,"
04/11/2022,20220411,202204,2022.15,2022,Amazon.com,Debit-Card,-847,10677,health,"None,"
04/11/2022,20220411,202204,2022.15,2022,Sysco,Debit-Card,-951,11524,paypal,"None,"
04/11/2022,20220411,202204,2022.15,2022,PPL,Debit-Card,963,12475,misc,"None,"
04/11/2022,20220411,202204,2022.15,2022,Ulta Beauty,Debit-Card,-647,11512,invest,"None,"
04/11/2022,20220411,202204,2022.15,2022,Hewlett Packard Enterprise,Debit-Card,-881,12159,health,"None,"
04/11/2022,20220411,202204,2022.15,2022,Cognizant Technology Solutions,Debit-Card,-350,13040,grocery,"None,"
04/11/2022,20220411,202204,2022.15,2022,Quest Diagnostics,Debit-Card,-279,13390,misc,"None,"
04/11/2022,20220411,202204,2022.15,2022,Walmart,Debit-Card,863,13669,health,"None,"
04/11/2022,20220411,202204,2022.15,2022,Amazon.com,Debit-Card,24,12806,tech,"None,"
04/11/2022,20220411,202204,2022.15,2022,United Continental Holdings,Debit-Card,173,12782,tech,"None,"
04/11/2022,20220411,202204,2022.15,2022,Travelers,Debit-Card,563,12609,unk,"None,"
04/11/2022,20220411,202204,2022.15,2022,CBRE Group,Debit-Card,973,12046,invest,"None,"
04/08/2022,20220408,202204,2022.14,2022,Quest Diagnostics,Debit-Card,195,11073,tech,"None,"
04/08/2022,20220408,202204,2022.14,2022,Amazon.com,Debit-Card,41,10878,debt,"None,"
04/08/2022,20220408,202204,2022.14,2022,Hanesbrands,Debit-Card,841,10837,grocery,"None,"
04/07/2022,20220407,202204,2022.14,2022,Ulta Beauty,Debit-Card,358,9996,misc,"None,"
04/07/2022,20220407,202204,2022.14,2022,Visa,Debit-Card,-818,9638,travel,"None,"
04/07/2022,20220407,202204,2022.14,2022,Cognizant Technology Solutions,Debit-Card,701,10456,grocery,"None,"
04/06/2022,20220406,202204,2022.14,2022,United Continental Holdings,Debit-Card,943,9755,misc,"None,"
04/05/2022,20220405,202204,2022.14,2022,Tapestry,Debit-Card,-748,8812,tech,"None,"
04/05/2022,20220405,202204,2022.14,2022,TIAA,Debit-Card,-729,9560,invest,"None,"
04/05/2022,20220405,202204,2022.14,2022,Hewlett Packard Enterprise,Debit-Card,-947,10289,health,"None,"
04/05/2022,20220405,202204,2022.14,2022,Hanesbrands,Debit-Card,618,11236,health,"None,"
04/04/2022,20220404,202204,2022.14,2022,Entergy,Debit-Card,235,10618,unk,"None,"
04/04/2022,20220404,202204,2022.14,2022,Sysco,Debit-Card,592,10383,tech,"None,"
04/04/2022,20220404,202204,2022.14,2022,Hanesbrands,Debit-Card,658,9791,grocery,"None,"
04/04/2022,20220404,202204,2022.14,2022,Quest Diagnostics,Debit-Card,-1,9133,misc,"None,"
04/04/2022,20220404,202204,2022.14,2022,Tapestry,Debit-Card,-823,9134,tech,"None,"
04/04/2022,20220404,202204,2022.14,2022,Delta Air Lines,Debit-Card,779,9957,travel,"None,"
04/04/2022,20220404,202204,2022.14,2022,PPL,Debit-Card,-444,9178,invest,"None,"
04/01/2022,20220401,202204,2022.13,2022,Hershey,Debit-Card,998,9622,invest,"None,"
03/31/2022,20220331,202203,2022.13,2022,Travelers,Debit-Card,-322,8624,health,"None,"
03/31/2022,20220331,202203,2022.13,2022,Sysco,Debit-Card,-675,8946,paypal,"None,"
03/31/2022,20220331,202203,2022.13,2022,TIAA,Debit-Card,897,9621,unk,"None,"
03/30/2022,20220330,202203,2022.13,2022,Omnicom Group,Debit-Card,906,8724,misc,"None,"
03/30/2022,20220330,202203,2022.13,2022,Quest Diagnostics,Debit-Card,-287,7818,utility,"None,"
03/28/2022,20220328,202203,2022.13,2022,CBRE Group,Debit-Card,-994,8105,health,"None,"
03/28/2022,20220328,202203,2022.13,2022,Walmart,Debit-Card,-575,9099,unk,"None,"
03/28/2022,20220328,202203,2022.13,2022,Hewlett Packard Enterprise,Debit-Card,-818,9674,invest,"None,"
03/28/2022,20220328,202203,2022.13,2022,PPL,Debit-Card,-453,10492,health,"None,"
03/25/2022,20220325,202203,2022.12,2022,Omnicom Group,Debit-Card,999,10945,invest,"None,"
03/24/2022,20220324,202203,2022.12,2022,Amazon.com,Debit-Card,537,9946,tech,"None,"
03/24/2022,20220324,202203,2022.12,2022,Visa,Debit-Card,799,9409,invest,"None,"
03/23/2022,20220323,202203,2022.12,2022,United Continental Holdings,Debit-Card,970,8610,health,"None,"
03/22/2022,20220322,202203,2022.12,2022,CBRE Group,Debit-Card,-78,7640,tech,"None,"
03/22/2022,20220322,202203,2022.12,2022,Hewlett Packard Enterprise,Debit-Card,-450,7718,tech,"None,"
03/22/2022,20220322,202203,2022.12,2022,Walmart,Debit-Card,-413,8168,travel,"None,"
03/22/2022,20220322,202203,2022.12,2022,Hewlett Packard Enterprise,Debit-Card,206,8581,health,"None,"
03/22/2022,20220322,202203,2022.12,2022,Visa,Debit-Card,-141,8375,grocery,"None,"
03/21/2022,20220321,202203,2022.12,2022,Tapestry,Debit-Card,-504,8516,unk,"None,"
03/21/2022,20220321,202203,2022.12,2022,Ulta Beauty,Debit-Card,-771,9020,health,"None,"
03/21/2022,20220321,202203,2022.12,2022,CBRE Group,Debit-Card,413,9791,unk,"None,"
03/21/2022,20220321,202203,2022.12,2022,CBRE Group,Debit-Card,494,9378,invest,"None,"
03/21/2022,20220321,202203,2022.12,2022,Walmart,Debit-Card,-250,8884,unk,"None,"
03/21/2022,20220321,202203,2022.12,2022,Visa,Debit-Card,-373,9134,health,"None,"
03/21/2022,20220321,202203,2022.12,2022,Cognizant Technology Solutions,Debit-Card,-67,9507,health,"None,"
03/18/2022,20220318,202203,2022.11,2022,Hanesbrands,Debit-Card,245,9574,misc,"None,"
03/18/2022,20220318,202203,2022.11,2022,Hershey,Debit-Card,270,9329,health,"None,"
03/18/2022,20220318,202203,2022.11,2022,Walmart,Debit-Card,-977,9059,health,"None,"
03/18/2022,20220318,202203,2022.11,2022,Cognizant Technology Solutions,Debit-Card,849,10036,travel,"None,"
03/18/2022,20220318,202203,2022.11,2022,Travelers,Debit-Card,5,9187,travel,"None,"
03/17/2022,20220317,202203,2022.11,2022,TIAA,Debit-Card,-565,9182,tech,"None,"
03/16/2022,20220316,202203,2022.11,2022,Quest Diagnostics,Debit-Card,19,9747,grocery,"None,"
03/16/2022,20220316,202203,2022.11,2022,Voya Financial,Debit-Card,-261,9728,invest,"None,"
03/16/2022,20220316,202203,2022.11,2022,Voya Financial,Debit-Card,-646,9989,paypal,"None,"
03/16/2022,20220316,202203,2022.11,2022,Walmart,Debit-Card,-914,10635,health,"None,"
03/15/2022,20220315,202203,2022.11,2022,Hanesbrands,Debit-Card,-734,11549,health,"None,"
03/15/2022,20220315,202203,2022.11,2022,Entergy,Debit-Card,549,12283,travel,"None,"
03/14/2022,20220314,202203,2022.11,2022,Amazon.com,Debit-Card,477,11734,grocery,"None,"
03/14/2022,20220314,202203,2022.11,2022,TIAA,Debit-Card,53,11257,grocery,"None,"
03/14/2022,20220314,202203,2022.11,2022,United Continental Holdings,Debit-Card,217,11204,grocery,"None,"
03/14/2022,20220314,202203,2022.11,2022,Hershey,Debit-Card,913,10987,invest,"None,"
03/14/2022,20220314,202203,2022.11,2022,Entergy,Debit-Card,482,10074,invest,"None,"
03/14/2022,20220314,202203,2022.11,2022,Voya Financial,Debit-Card,-844,9592,health,"None,"
03/14/2022,20220314,202203,2022.11,2022,United Continental Holdings,Debit-Card,-615,10436,health,"None,"
03/14/2022,20220314,202203,2022.11,2022,PPL,Debit-Card,-69,11051,tech,"None,"
03/14/2022,20220314,202203,2022.11,2022,Cognizant Technology Solutions,Debit-Card,-173,11120,grocery,"None,"
03/11/2022,20220311,202203,2022.1,2022,Walmart,Debit-Card,162,11293,debt,"None,"
03/11/2022,20220311,202203,2022.1,2022,Hewlett Packard Enterprise,Debit-Card,620,11131,invest,"None,"
03/11/2022,20220311,202203,2022.1,2022,Hanesbrands,Debit-Card,678,10511,unk,"None,"
03/11/2022,20220311,202203,2022.1,2022,Hershey,Debit-Card,324,9833,travel,"None,"
03/10/2022,20220310,202203,2022.1,2022,Tapestry,Debit-Card,-268,9509,utility,"None,"
03/09/2022,20220309,202203,2022.1,2022,Voya Financial,Debit-Card,-38,9777,health,"None,"
03/07/2022,20220307,202203,2022.1,2022,CBRE Group,Debit-Card,-476,9815,travel,"None,"
03/07/2022,20220307,202203,2022.1,2022,Visa,Debit-Card,-259,10291,paypal,"None,"
03/07/2022,20220307,202203,2022.1,2022,Travelers,Debit-Card,173,10550,unk,"None,"
03/07/2022,20220307,202203,2022.1,2022,PPL,Debit-Card,651,10377,grocery,"None,"
03/07/2022,20220307,202203,2022.1,2022,Cognizant Technology Solutions,Debit-Card,714,9726,health,"None,"
03/07/2022,20220307,202203,2022.1,2022,United Continental Holdings,Debit-Card,-791,9012,utility,"None,"
03/04/2022,20220304,202203,2022.09,2022,Hanesbrands,Debit-Card,276,9803,invest,"None,"
03/04/2022,20220304,202203,2022.09,2022,PPL,Debit-Card,651,9527,tech,"None,"
03/03/2022,20220303,202203,2022.09,2022,Walmart,Debit-Card,81,8876,misc,"None,"
03/03/2022,20220303,202203,2022.09,2022,Tapestry,Debit-Card,775,8795,unk,"None,"
03/03/2022,20220303,202203,2022.09,2022,Walmart,Debit-Card,-524,8020,misc,"None,"
03/02/2022,20220302,202203,2022.09,2022,Voya Financial,Debit-Card,334,8544,invest,"None,"
03/02/2022,20220302,202203,2022.09,2022,Hewlett Packard Enterprise,Debit-Card,925,8210,tech,"None,"
03/02/2022,20220302,202203,2022.09,2022,United Continental Holdings,Debit-Card,-85,7285,tech,"None,"
03/01/2022,20220301,202203,2022.09,2022,Cognizant Technology Solutions,Debit-Card,-487,7370,tech,"None,"
03/01/2022,20220301,202203,2022.09,2022,Tapestry,Debit-Card,582,7857,tech,"None,"
03/01/2022,20220301,202203,2022.09,2022,Ulta Beauty,Debit-Card,268,7275,health,"None,"
03/01/2022,20220301,202203,2022.09,2022,Hershey,Debit-Card,-447,7007,travel,"None,"
02/28/2022,20220228,202202,2022.09,2022,Travelers,Debit-Card,684,7454,grocery,"None,"
02/28/2022,20220228,202202,2022.09,2022,Quest Diagnostics,Debit-Card,251,6770,invest,"None,"
02/28/2022,20220228,202202,2022.09,2022,Delta Air Lines,Debit-Card,-55,6519,clothing,"None,"
02/28/2022,20220228,202202,2022.09,2022,Entergy,Debit-Card,-968,6574,misc,"None,"
02/25/2022,20220225,202202,2022.08,2022,Walmart,Debit-Card,920,7542,grocery,"None,"
02/25/2022,20220225,202202,2022.08,2022,Hanesbrands,Debit-Card,914,6622,invest,"None,"
02/25/2022,20220225,202202,2022.08,2022,Delta Air Lines,Debit-Card,563,5708,clothing,"None,"
02/25/2022,20220225,202202,2022.08,2022,Visa,Debit-Card,-455,5145,travel,"None,"
02/25/2022,20220225,202202,2022.08,2022,Amazon.com,Debit-Card,-959,5600,misc,"None,"
02/25/2022,20220225,202202,2022.08,2022,Quest Diagnostics,Debit-Card,-767,6559,invest,"None,"
02/24/2022,20220224,202202,2022.08,2022,Entergy,Debit-Card,654,7326,misc,"None,"
02/23/2022,20220223,202202,2022.08,2022,Ulta Beauty,Debit-Card,-747,6672,health,"None,"
01/24/2022,20220124,202201,2022.04,2022,PPL,Debit-Card,762,7419,invest,"None,"
01/24/2022,20220124,202201,2022.04,2022,Cognizant Technology Solutions,Debit-Card,881,6657,unk,"None,"
01/24/2022,20220124,202201,2022.04,2022,Travelers,Debit-Card,-198,5776,utility,"None,"
01/24/2022,20220124,202201,2022.04,2022,Travelers,Debit-Card,902,5974,invest,"None,"
01/24/2022,20220124,202201,2022.04,2022,Entergy,Debit-Card,869,5072,grocery,"None,"
01/24/2022,20220124,202201,2022.04,2022,Voya Financial,Debit-Card,-995,4203,invest,"None,"
01/24/2022,20220124,202201,2022.04,2022,CBRE Group,Debit-Card,-527,5198,invest,"None,"
01/21/2022,20220121,202201,2022.03,2022,United Continental Holdings,Debit-Card,-578,5725,debt,"None,"
01/21/2022,20220121,202201,2022.03,2022,Hanesbrands,Debit-Card,810,6303,unk,"None,"
01/21/2022,20220121,202201,2022.03,2022,Walmart,Debit-Card,259,5493,misc,"None,"
01/20/2022,20220120,202201,2022.03,2022,Travelers,Debit-Card,784,5234,travel,"None,"
01/20/2022,20220120,202201,2022.03,2022,Hewlett Packard Enterprise,Debit-Card,653,4450,debt,"None,"
01/20/2022,20220120,202201,2022.03,2022,Delta Air Lines,Debit-Card,-268,3797,invest,"None,"
01/19/2022,20220119,202201,2022.03,2022,Delta Air Lines,Debit-Card,276,4065,travel,"None,"
01/19/2022,20220119,202201,2022.03,2022,Amazon.com,Debit-Card,-322,3789,paypal,"None,"
01/18/2022,20220118,202201,2022.03,2022,TIAA,Debit-Card,68,4111,invest,"None,"
01/18/2022,20220118,202201,2022.03,2022,CBRE Group,Debit-Card,148,4043,misc,"None,"
01/18/2022,20220118,202201,2022.03,2022,Voya Financial,Debit-Card,17,3895,utility,"None,"
01/18/2022,20220118,202201,2022.03,2022,Cognizant Technology Solutions,Debit-Card,484,3878,travel,"None,"
01/18/2022,20220118,202201,2022.03,2022,Tapestry,Debit-Card,33,3394,invest,"None,"
01/18/2022,20220118,202201,2022.03,2022,Delta Air Lines,Debit-Card,181,3361,grocery,"None,"
01/18/2022,20220118,202201,2022.03,2022,Quest Diagnostics,Debit-Card,776,3180,invest,"None,"
01/18/2022,20220118,202201,2022.03,2022,Ulta Beauty,Debit-Card,47,2404,debt,"None,"
01/18/2022,20220118,202201,2022.03,2022,Omnicom Group,Debit-Card,62,2357,grocery,"None,"
01/18/2022,20220118,202201,2022.03,2022,Hershey,Debit-Card,972,2295,paypal,"None,"
01/14/2022,20220114,202201,2022.02,2022,Quest Diagnostics,Debit-Card,944,1323,unk,"None,"
01/14/2022,20220114,202201,2022.02,2022,PPL,Debit-Card,-506,379,unk,"None,"
01/13/2022,20220113,202201,2022.02,2022,Omnicom Group,Debit-Card,-77,885,health,"None,"
01/13/2022,20220113,202201,2022.02,2022,Ulta Beauty,Debit-Card,293,962,clothing,"None,"
01/13/2022,20220113,202201,2022.02,2022,Voya Financial,Debit-Card,-438,669,invest,"None,"
01/12/2022,20220112,202201,2022.02,2022,Travelers,Debit-Card,753,1107,clothing,"None,"
01/11/2022,20220111,202201,2022.02,2022,Hershey,Debit-Card,-737,354,misc,"None,"
01/10/2022,20220110,202201,2022.02,2022,Amazon.com,Debit-Card,366,1091,misc,"None,"
01/10/2022,20220110,202201,2022.02,2022,Voya Financial,Debit-Card,934,725,grocery,"None,"
01/10/2022,20220110,202201,2022.02,2022,Amazon.com,Debit-Card,-755,-209,tech,"None,"
01/07/2022,20220107,202201,2022.01,2022,Hanesbrands,Debit-Card,245,546,debt,"None,"
01/07/2022,20220107,202201,2022.01,2022,Cognizant Technology Solutions,Debit-Card,-784,301,health,"None,"
01/06/2022,20220106,202201,2022.01,2022,Omnicom Group,Debit-Card,376,1085,invest,"None,"
01/05/2022,20220105,202201,2022.01,2022,Omnicom Group,Debit-Card,-109,709,health,"None,"
01/03/2022,20220103,202201,2022.01,2022,TIAA,Debit-Card,458,818,invest,"None,"
01/03/2022,20220103,202201,2022.01,2022,TIAA,Debit-Card,-684,360,utility,"None,"
01/03/2022,20220103,202201,2022.01,2022,PPL,Debit-Card,-479,1044,paypal,"None,"
01/03/2022,20220103,202201,2022.01,2022,Hanesbrands,Debit-Card,-975,1523,clothing,"None,"
01/03/2022,20220103,202201,2022.01,2022,Voya Financial,Debit-Card,376,2498,debt,"None,"
01/03/2022,20220103,202201,2022.01,2022,Visa,Debit-Card,852,2122,tech,"None,"
